query	reference	pident	alnlen	qstart	qend	rstart	rend	nt_match	nt_mismatch
NC_025457.alt2	NC_025457.ref	89.2893	999	22119	23117	14207	15163	892	107
NC_025457.alt2	NC_025457.ref	89.8305	826	3373	4198	2202	3020	742	84
NC_025457.alt2	NC_025457.ref	91.0804	796	41697	42492	27680	28475	725	71
NC_025457.alt2	NC_025457.ref	87.2483	745	38039	38783	24969	25688	650	95
NC_025457.alt2	NC_025457.ref	89.8860	702	7269	7970	5077	5778	631	71
NC_025457.alt2	NC_025457.ref	93.2081	692	62572	63263	41329	42020	645	47
NC_025457.alt2	NC_025457.ref	90.9565	575	31121	31695	20438	21003	523	52
NC_025457.alt2	NC_025457.ref	90.6195	565	11476	12040	7999	8563	512	53
NC_025457.alt2	NC_025457.ref	91.6211	549	10905	11453	7455	8003	503	46
NC_025457.alt2	NC_025457.ref	86.7041	534	29624	30157	19067	19586	463	71
NC_025457.alt2	NC_025457.ref	93.5673	513	10149	10661	6915	7427	480	33
NC_025457.alt2	NC_025457.ref	89.3701	508	34017	34524	22188	22695	454	54
NC_025457.alt2	NC_025457.ref	88.0240	501	18330	18830	11549	12049	441	60
NC_025457.alt2	NC_025457.ref	90.4	500	41145	41644	27228	27712	452	48
NC_025457.alt2	NC_025457.ref	92	500	54198	54697	36341	36840	460	40
NC_025457.alt2	NC_025457.ref	95.0413	484	9665	10148	6606	7089	460	24
NC_025457.alt2	NC_025457.ref	92.7813	471	27972	28442	18058	18528	437	34
NC_025457.alt2	NC_025457.ref	87.1179	458	26320	26777	17020	17477	399	59
NC_025457.alt2	NC_025457.ref	91.7960	451	59790	60240	39848	40298	414	37
NC_025457.alt2	NC_025457.ref	97.3333	450	6115	6564	4480	4929	438	12
NC_025457.alt2	NC_025457.ref	90.8884	439	12287	12725	8564	9002	399	40
NC_025457.alt2	NC_025457.ref	87.6712	438	14593	15030	9680	10117	384	54
NC_025457.alt2	NC_025457.ref	89.6789	436	8881	9316	6028	6463	391	45
NC_025457.alt2	NC_025457.ref	92.3077	429	50098	50526	33535	33963	396	33
NC_025457.alt2	NC_025457.ref	88.0562	427	5318	5744	3980	4406	376	51
NC_025457.alt2	NC_025457.ref	88.9930	427	49023	49449	32454	32880	380	47
NC_025457.alt2	NC_025457.ref	88.6792	424	53042	53465	35516	35939	376	48
NC_025457.alt2	NC_025457.ref	90.3073	423	580	1002	388	810	382	41
NC_025457.alt2	NC_025457.ref	94.7619	420	30701	31120	20176	20595	398	22
NC_025457.alt2	NC_025457.ref	94.9761	418	25550	25967	16535	16952	397	21
NC_025457.alt2	NC_025457.ref	84.1727	417	34823	35239	22821	23222	351	66
NC_025457.alt2	NC_025457.ref	96.0976	410	27426	27835	17649	18058	394	16
NC_025457.alt2	NC_025457.ref	90.6404	406	53698	54103	35937	36340	368	38
NC_025457.alt2	NC_025457.ref	88.8325	394	36277	36670	23874	24267	350	44
NC_025457.alt2	NC_025457.ref	88.1748	389	2083	2471	1293	1654	343	46
NC_025457.alt2	NC_025457.ref	95.9677	372	55363	55734	37117	37488	357	15
NC_025457.alt2	NC_025457.ref	94.5205	365	48258	48622	31760	32124	345	20
NC_025457.alt2	NC_025457.ref	89.4150	359	36758	37116	24355	24713	321	38
NC_025457.alt2	NC_025457.ref	88.3008	359	63272	63630	42026	42381	317	42
NC_025457.alt2	NC_025457.ref	78.4314	357	47259	47615	31324	31621	280	77
NC_025457.alt2	NC_025457.ref	96.8300	347	55016	55362	36860	37206	336	11
NC_025457.alt2	NC_025457.ref	95.6647	346	60312	60657	40301	40646	331	15
NC_025457.alt2	NC_025457.ref	95.0725	345	45749	46093	30270	30614	328	17
NC_025457.alt2	NC_025457.ref	91.2281	342	52606	52947	35175	35516	312	30
NC_025457.alt2	NC_025457.ref	87.8049	328	44805	45132	29717	30044	288	40
NC_025457.alt2	NC_025457.ref	91.3846	325	39657	39981	26278	26602	297	28
NC_025457.alt2	NC_025457.ref	90.1235	324	30361	30684	19850	20173	292	32
NC_025457.alt2	NC_025457.ref	91.2773	321	31904	32224	21004	21324	293	28
NC_025457.alt2	NC_025457.ref	99.3711	318	54698	55015	36694	37011	316	2
NC_025457.alt2	NC_025457.ref	87.4598	311	1431	1741	947	1281	272	39
NC_025457.alt2	NC_025457.ref	88.3495	309	19063	19371	12385	12687	273	36
NC_025457.alt2	NC_025457.ref	90.9385	309	46342	46650	30614	30922	281	28
NC_025457.alt2	NC_025457.ref	85.5263	304	24452	24755	15890	16193	260	44
NC_025457.alt2	NC_025457.ref	90.8784	296	40768	41063	26932	27227	269	27
NC_025457.alt2	NC_025457.ref	91.5541	296	59494	59789	39635	39930	271	25
NC_025457.alt2	NC_025457.ref	94.8980	294	58795	59088	39205	39498	279	15
NC_025457.alt2	NC_025457.ref	95.5017	289	4802	5090	3688	3976	276	13
NC_025457.alt2	NC_025457.ref	97.2318	289	19612	19900	12696	12984	281	8
NC_025457.alt2	NC_025457.ref	97.2125	287	20209	20495	13012	13298	279	8
NC_025457.alt2	NC_025457.ref	89.8955	287	25968	26254	16774	17053	258	29
NC_025457.alt2	NC_025457.ref	93.9716	282	35333	35614	23347	23628	265	17
NC_025457.alt2	NC_025457.ref	86.8327	281	32820	33100	21491	21771	244	37
NC_025457.alt2	NC_025457.ref	93.5484	279	61259	61537	40677	40955	261	18
NC_025457.alt2	NC_025457.ref	90.9420	276	21656	21931	13935	14210	251	25
NC_025457.alt2	NC_025457.ref	1e+02	274	47616	47889	38723	38996	274	0
NC_025457.alt2	NC_025457.ref	89.2193	269	15633	15901	10336	10604	240	29
NC_025457.alt2	NC_025457.ref	80.8271	266	63785	64050	42382	42636	215	51
NC_025457.alt2	NC_025457.ref	98.1061	264	28443	28706	18358	18621	259	5
NC_025457.alt2	NC_025457.ref	95.3488	258	27168	27425	17540	17797	246	12
NC_025457.alt2	NC_025457.ref	94.1634	257	59089	59345	39378	39634	242	15
NC_025457.alt2	NC_025457.ref	85.3755	253	50712	50964	33962	34204	216	37
NC_025457.alt2	NC_025457.ref	90.0794	252	43284	43535	28775	29026	227	25
NC_025457.alt2	NC_025457.ref	1e+02	252	45497	45748	12133	12384	252	0
NC_025457.alt2	NC_025457.ref	90.3614	249	290	538	140	388	225	24
NC_025457.alt2	NC_025457.ref	90.7631	249	56801	57049	37851	38099	226	23
NC_025457.alt2	NC_025457.ref	91.9355	248	9417	9664	6475	6722	228	20
NC_025457.alt2	NC_025457.ref	1e+02	246	12041	12286	33124	32879	246	0
NC_025457.alt2	NC_025457.ref	91.3934	244	17300	17543	11055	11298	223	21
NC_025457.alt2	NC_025457.ref	95.9016	244	42843	43086	28541	28784	234	10
NC_025457.alt2	NC_025457.ref	88.1148	244	45253	45496	30036	30279	215	29
NC_025457.alt2	NC_025457.ref	93.0328	244	48014	48257	31645	31888	227	17
NC_025457.alt2	NC_025457.ref	97.5	240	5875	6114	4404	4643	234	6
NC_025457.alt2	NC_025457.ref	90.8333	240	52203	52442	34881	35120	218	22
NC_025457.alt2	NC_025457.ref	90.3361	238	21046	21283	13571	13808	215	23
NC_025457.alt2	NC_025457.ref	95.7447	235	55735	55969	37333	37601	225	10
NC_025457.alt2	NC_025457.ref	88.8412	233	38840	39072	25688	25920	207	26
NC_025457.alt2	NC_025457.ref	90.5172	232	24832	25063	16178	16409	210	22
NC_025457.alt2	NC_025457.ref	89.1304	230	37452	37681	24719	24948	205	25
NC_025457.alt2	NC_025457.ref	79.4760	229	44110	44338	29267	29461	182	47
NC_025457.alt2	NC_025457.ref	90.7895	228	4574	4801	3247	3472	207	21
NC_025457.alt2	NC_025457.ref	86.4035	228	43773	44000	29059	29268	197	31
NC_025457.alt2	NC_025457.ref	96.875	224	6565	6788	4770	4993	217	7
NC_025457.alt2	NC_025457.ref	96.3636	220	42623	42842	28478	28697	212	8
NC_025457.alt2	NC_025457.ref	89.3519	216	51176	51391	34203	34415	193	23
NC_025457.alt2	NC_025457.ref	99.5327	214	19901	20114	12796	13009	213	1
NC_025457.alt2	NC_025457.ref	87.8505	214	35813	36026	23628	23841	188	26
NC_025457.alt2	NC_025457.ref	92.3445	209	40199	40407	26605	26813	193	16
NC_025457.alt2	NC_025457.ref	87.9808	208	3137	3344	1996	2203	183	25
NC_025457.alt2	NC_025457.ref	91.4573	199	2796	2994	1797	1995	182	17
NC_025457.alt2	NC_025457.ref	96.9388	196	14043	14238	15359	15164	190	6
NC_025457.alt2	NC_025457.ref	96.3918	194	57153	57346	38089	38282	187	7
NC_025457.alt2	NC_025457.ref	98.9637	193	57347	57539	38104	38296	191	2
NC_025457.alt2	NC_025457.ref	87.3684	190	20572	20761	13283	13472	166	24
NC_025457.alt2	NC_025457.ref	1e+02	188	8312	8499	30923	31110	188	0
NC_025457.alt2	NC_025457.ref	92.5532	188	12745	12932	9001	9188	174	14
NC_025457.alt2	NC_025457.ref	95.7219	187	51768	51954	34556	34742	179	8
NC_025457.alt2	NC_025457.ref	93.9891	183	58271	58453	38539	38721	172	11
NC_025457.alt2	NC_025457.ref	73.0769	182	48701	48882	32303	32450	133	49
NC_025457.alt2	NC_025457.ref	90.1099	182	56513	56694	37668	37849	164	18
NC_025457.alt2	NC_025457.ref	98.3333	180	23118	23297	15349	15528	177	3
NC_025457.alt2	NC_025457.ref	86.0335	179	16844	17022	10873	11051	154	25
NC_025457.alt2	NC_025457.ref	90.3409	176	61575	61750	40960	41135	159	17
NC_025457.alt2	NC_025457.ref	97.7143	175	33405	33579	21861	22035	171	4
NC_025457.alt2	NC_025457.ref	88.5057	174	16550	16723	10700	10873	154	20
NC_025457.alt2	NC_025457.ref	98.7805	164	49934	50097	33512	33675	162	2
NC_025457.alt2	NC_025457.ref	85.2761	163	17739	17901	11300	11462	139	24
NC_025457.alt2	NC_025457.ref	84.0491	163	39238	39400	25898	26060	137	26
NC_025457.alt2	NC_025457.ref	98.7730	163	51955	52117	34633	34795	161	2
NC_025457.alt2	NC_025457.ref	92.4051	158	32427	32584	21334	21491	146	12
NC_025457.alt2	NC_025457.ref	94.9045	157	58114	58270	38467	38623	149	8
NC_025457.alt2	NC_025457.ref	87.7419	155	29168	29322	18740	18894	136	19
NC_025457.alt2	NC_025457.ref	71.6129	155	57828	57982	38367	38505	111	44
NC_025457.alt2	NC_025457.ref	90.9091	154	15132	15285	10121	10274	140	14
NC_025457.alt2	NC_025457.ref	98.7013	154	23298	23451	15392	15545	152	2
NC_025457.alt2	NC_025457.ref	1e+02	154	63631	63784	3019	3172	154	0
NC_025457.alt2	NC_025457.ref	96.0784	153	1930	2082	1237	1389	147	6
NC_025457.alt2	NC_025457.ref	88.0795	151	33796	33946	22045	22195	133	18
NC_025457.alt2	NC_025457.ref	86.6667	150	13053	13202	9176	9325	130	20
NC_025457.alt2	NC_025457.ref	91.1565	147	8500	8646	5882	6028	134	13
NC_025457.alt2	NC_025457.ref	88.0282	142	51444	51585	34409	34550	125	17
NC_025457.alt2	NC_025457.ref	92.9078	141	2592	2732	1656	1796	131	10
NC_025457.alt2	NC_025457.ref	89.2857	140	1	140	1	140	125	15
NC_025457.alt2	NC_025457.ref	1e+02	140	49794	49933	33511	33372	140	0
NC_025457.alt2	NC_025457.ref	89.9281	139	23905	24043	15656	15794	125	14
NC_025457.alt2	NC_025457.ref	84.6715	137	28814	28950	18621	18769	116	21
NC_025457.alt2	NC_025457.ref	87.4016	127	1100	1226	817	943	111	16
NC_025457.alt2	NC_025457.ref	1e+02	120	17902	18021	32124	32243	120	0
NC_025457.alt2	NC_025457.ref	1e+02	119	39401	39519	26178	26060	119	0
NC_025457.alt2	NC_025457.ref	1e+02	118	33580	33697	21934	22051	118	0
NC_025457.alt2	NC_025457.ref	1e+02	117	43656	43772	29027	29143	117	0
NC_025457.alt2	NC_025457.ref	74.1379	116	13672	13787	9472	9561	86	30
NC_025457.alt2	NC_025457.ref	1e+02	114	23788	23901	23309	23196	114	0
NC_025457.alt2	NC_025457.ref	1e+02	114	58681	58794	39204	39091	114	0
NC_025457.alt2	NC_025457.ref	90.1786	112	47042	47153	31214	31325	101	11
NC_025457.alt2	NC_025457.ref	81.0811	111	6998	7108	4990	5093	90	21
NC_025457.alt2	NC_025457.ref	89.6226	106	44381	44486	29462	29567	95	11
NC_025457.alt2	NC_025457.ref	1e+02	106	56695	56800	19719	19824	106	0
NC_025457.alt2	NC_025457.ref	91.4286	105	20894	20998	13473	13577	96	9
NC_025457.alt2	NC_025457.ref	92.1569	102	23686	23787	15553	15654	94	8
NC_025457.alt2	NC_025457.ref	84.3137	102	62398	62499	41227	41328	86	16
NC_025457.alt2	NC_025457.ref	1e+02	101	34527	34627	22798	22698	101	0
NC_025457.alt2	NC_025457.ref	89.1089	101	49450	49550	33127	33227	90	11
NC_025457.alt2	NC_025457.ref	1e+02	96	44487	44582	29653	29558	96	0
NC_025457.alt2	NC_025457.ref	91.4894	94	39523	39616	26183	26276	86	8
NC_025457.alt2	NC_025457.ref	1e+02	94	54104	54197	18988	18895	94	0
NC_025457.alt2	NC_025457.ref	91.3043	92	13336	13427	9329	9420	84	8
NC_025457.alt2	NC_025457.ref	1e+02	91	40408	40498	26904	26814	91	0
NC_025457.alt2	NC_025457.ref	89.5349	86	18022	18107	11463	11548	77	9
NC_025457.alt2	NC_025457.ref	89.5349	86	33233	33318	21772	21857	77	9
NC_025457.alt2	NC_025457.ref	1e+02	85	52118	52202	34880	34796	85	0
NC_025457.alt2	NC_025457.ref	1e+02	84	36671	36754	24349	24266	84	0
NC_025457.alt2	NC_025457.ref	1e+02	83	33319	33401	33312	33230	83	0
NC_025457.alt2	NC_025457.ref	86.5854	82	29325	29406	18991	19072	71	11
NC_025457.alt2	NC_025457.ref	91.4634	82	57699	57780	38297	38378	75	7
NC_025457.alt2	NC_025457.ref	9e+01	80	58601	58680	39011	39090	72	8
NC_025457.alt2	NC_025457.ref	87.0130	77	8200	8276	5779	5855	67	10
NC_025457.alt2	NC_025457.ref	89.0411	73	25147	25219	16410	16482	65	8
NC_025457.alt2	NC_025457.ref	89.5522	67	18996	19062	12056	12122	60	7
NC_025457.alt2	NC_025457.ref	89.0625	64	21309	21372	13814	13877	57	7
NC_025457.alt2	NC_025457.ref	88.7097	62	61977	62038	41135	41196	55	7
NC_025457.alt2	NC_025457.ref	90.1639	61	26968	27028	17479	17539	55	6
NC_025457.alt2	NC_025457.ref	59.0164	61	47179	47239	33755	33810	36	25
NC_025457.alt2	NC_025457.ref	91.6667	60	24275	24334	15830	15889	55	5
NC_025457.alt2	NC_025457.ref	87.9310	58	15459	15516	10278	10335	51	7
NC_025457.alt2	NC_025457.ref	39.6552	58	20514	20571	5303	5258	23	35
NC_025457.alt2	NC_025457.ref	42.8571	56	4305	4360	18282	18236	24	32
NC_025457.alt2	NC_025457.ref	48.2143	56	40606	40661	24568	24480	27	29
NC_025457.alt2	NC_025457.ref	96.3636	55	4199	4253	3175	3229	53	2
NC_025457.alt2	NC_025457.ref	89.0909	55	21497	21551	13880	13934	49	6
NC_025457.alt2	NC_025457.ref	90.5660	53	16301	16353	10644	10696	48	5
NC_025457.alt2	NC_025457.ref	96.2264	53	30208	30260	19666	19718	51	2
NC_025457.alt2	NC_025457.ref	94.3396	53	48628	48680	32250	32302	50	3
NC_025457.alt2	NC_025457.ref	90.1961	51	13482	13532	9419	9469	46	5
NC_025457.alt2	NC_025457.ref	88.2353	51	46651	46701	31111	31161	45	6
NC_025457.alt2	NC_025457.ref	88	50	36125	36174	23843	23892	44	6
NC_025457.alt2	NC_025457.ref	92	50	46830	46879	31161	31210	46	4
NC_025457.alt2	NC_025457.ref	83.6735	49	44583	44631	29664	29712	41	8
NC_025457.alt2	NC_025457.ref	95.9184	49	52550	52598	35123	35171	47	2
NC_025457.alt2	NC_025457.ref	62.5	48	1034	1081	41979	42030	30	18
NC_025457.alt2	NC_025457.ref	65.2174	46	5261	5306	8881	8931	30	16
NC_025457.alt2	NC_025457.ref	90.9091	44	62217	62260	41199	41242	40	4
NC_025457.alt2	NC_025457.ref	95.4545	44	64121	64164	42611	42654	42	2
NC_025457.alt2	NC_025457.ref	54.7619	42	61012	61053	36901	36966	23	19
NC_025457.alt2	NC_025457.ref	58.5366	41	17613	17653	21438	21376	24	17
NC_025457.alt2	NC_025457.ref	82.0513	39	24142	24180	15795	15833	32	7
NC_025457.alt2	NC_025457.ref	65.7895	38	44755	44792	27348	27376	25	13
NC_025457.alt2	NC_025457.ref	94.7368	38	49756	49793	33334	33371	36	2
NC_025457.alt2	NC_025457.ref	97.1429	35	16146	16180	10607	10641	34	1
NC_025457.alt2	NC_025457.ref	65.7143	35	47952	47986	38289	38255	23	12
NC_025457.alt2	NC_010807.alt1	51.1450	131	21254	21384	35412	35196	67	64
NC_025457.alt2	NC_010807.alt1	49.4505	91	40328	40418	33475	33548	45	46
NC_025457.alt2	NC_010807.alt1	60.7143	84	31469	31552	4319	4403	51	33
NC_025457.alt2	NC_010807.alt1	56.3380	71	36506	36576	16728	16828	40	31
NC_025457.alt2	NC_010807.alt1	60.2941	68	13960	14027	9899	9972	41	27
NC_025457.alt2	NC_010807.alt1	54.5455	66	5961	6026	26271	26180	36	30
NC_025457.alt2	NC_010807.alt1	54.5455	66	6125	6190	26271	26180	36	30
NC_025457.alt2	NC_010807.alt1	5e+01	66	19219	19284	14012	13962	33	33
NC_025457.alt2	NC_010807.alt1	54.5455	66	28202	28267	10783	10698	36	30
NC_025457.alt2	NC_010807.alt1	44.6154	65	5626	5690	11762	11833	29	36
NC_025457.alt2	NC_010807.alt1	54.2373	59	13008	13066	34992	34906	32	27
NC_025457.alt2	NC_010807.alt1	47.4576	59	46853	46911	29693	29737	28	31
NC_025457.alt2	NC_010807.alt1	43.1034	58	52520	52577	27622	27572	25	33
NC_025457.alt2	NC_010807.alt1	61.4035	57	17239	17295	35144	35051	35	22
NC_025457.alt2	NC_010807.alt1	49.1228	57	19056	19112	17986	17941	28	29
NC_025457.alt2	NC_010807.alt1	47.3684	57	45810	45866	36171	36214	27	30
NC_025457.alt2	NC_010807.alt1	59.6491	57	58063	58119	34835	34787	34	23
NC_025457.alt2	NC_010807.alt1	60.7143	56	18450	18505	36510	36596	34	22
NC_025457.alt2	NC_010807.alt1	66.0714	56	21634	21689	13247	13330	37	19
NC_025457.alt2	NC_010807.alt1	47.2727	55	62576	62630	25051	25096	26	29
NC_025457.alt2	NC_010807.alt1	51.8519	54	2641	2694	26953	26998	28	26
NC_025457.alt2	NC_010807.alt1	57.6923	52	22304	22355	18017	17974	30	22
NC_025457.alt2	NC_010807.alt1	54.9020	51	13087	13137	15562	15619	28	23
NC_025457.alt2	NC_010807.alt1	56.8627	51	26646	26696	15322	15411	29	22
NC_025457.alt2	NC_010807.alt1	5e+01	50	2704	2753	16192	16247	25	25
NC_025457.alt2	NC_010807.alt1	56	50	4974	5023	18608	18687	28	22
NC_025457.alt2	NC_010807.alt1	66	50	46930	46979	29486	29532	33	17
NC_025457.alt2	NC_010807.alt1	57.1429	49	14283	14331	25350	25388	28	21
NC_025457.alt2	NC_010807.alt1	56.25	48	31245	31292	28879	28962	27	21
NC_025457.alt2	NC_010807.alt1	61.7021	47	39115	39161	37949	37888	29	18
NC_025457.alt2	NC_010807.alt1	63.8298	47	48565	48611	19067	19136	30	17
NC_025457.alt2	NC_010807.alt1	78.7234	47	57529	57575	21948	21913	37	10
NC_025457.alt2	NC_010807.alt1	69.5652	46	43632	43677	20392	20463	32	14
NC_025457.alt2	NC_010807.alt1	65.2174	46	60049	60094	23279	23222	30	16
NC_025457.alt2	NC_010807.alt1	55.5556	45	28296	28340	18524	18561	25	20
NC_025457.alt2	NC_010807.alt1	55.5556	45	28467	28511	18524	18561	25	20
NC_025457.alt2	NC_010807.alt1	64.4444	45	36330	36374	8844	8885	29	16
NC_025457.alt2	NC_010807.alt1	6e+01	45	37016	37060	145	191	27	18
NC_025457.alt2	NC_010807.alt1	52.3810	42	27880	27921	16092	16123	22	20
NC_025457.alt2	NC_010807.alt1	66.6667	42	30161	30202	25842	25788	28	14
NC_025457.alt2	NC_010807.alt1	58.5366	41	6473	6513	7528	7578	24	17
NC_025457.alt2	NC_010807.alt1	58.5366	41	6633	6673	7528	7578	24	17
NC_025457.alt2	NC_010807.alt1	7e+01	40	1743	1782	4197	4158	28	12
NC_025457.alt2	NC_010807.alt1	62.5	40	60956	60995	32659	32600	25	15
NC_025457.alt2	NC_010807.alt1	66.6667	39	46123	46161	1081	1145	26	13
NC_025457.alt2	NC_010807.alt1	65.7143	35	61971	62005	31013	30959	23	12
NC_025457.alt2	NC_025457.alt1	89.3741	687	30403	31089	18593	19282	614	73
NC_025457.alt2	NC_025457.alt1	91	500	54198	54697	34637	35136	455	45
NC_025457.alt2	NC_025457.alt1	92.1444	471	27972	28442	17163	17633	434	37
NC_025457.alt2	NC_025457.alt1	92.5439	456	41844	42299	26850	27318	422	34
NC_025457.alt2	NC_025457.alt1	94.3311	441	62823	63263	39800	40240	416	25
NC_025457.alt2	NC_025457.alt1	83.9329	417	34823	35239	21596	21997	350	67
NC_025457.alt2	NC_025457.alt1	96.0976	410	27426	27835	16754	17163	394	16
NC_025457.alt2	NC_025457.alt1	95.7560	377	25591	25967	15857	16233	361	16
NC_025457.alt2	NC_025457.alt1	95.6989	372	55363	55734	35509	35880	356	16
NC_025457.alt2	NC_025457.alt1	89.1892	370	49080	49449	31352	31721	330	40
NC_025457.alt2	NC_025457.alt1	92.3913	368	9781	10148	6022	6389	340	28
NC_025457.alt2	NC_025457.alt1	86.3388	366	26320	26685	16301	16666	316	50
NC_025457.alt2	NC_025457.alt1	86.7606	355	3841	4195	2460	2805	308	47
NC_025457.alt2	NC_025457.alt1	88.3191	351	53042	53392	33605	33955	310	41
NC_025457.alt2	NC_025457.alt1	89.1117	349	11476	11824	7696	8044	311	38
NC_025457.alt2	NC_025457.alt1	95.0725	345	45749	46093	29080	29424	328	17
NC_025457.alt2	NC_025457.alt1	91.3846	325	39657	39981	25095	25419	297	28
NC_025457.alt2	NC_025457.alt1	76.7802	323	47293	47615	30325	30588	248	75
NC_025457.alt2	NC_025457.alt1	90.0312	321	31904	32224	19809	20129	289	32
NC_025457.alt2	NC_025457.alt1	99.0566	318	54698	55015	34990	35307	315	3
NC_025457.alt2	NC_025457.alt1	89.2405	316	7655	7970	4978	5293	282	34
NC_025457.alt2	NC_025457.alt1	85.5305	311	1431	1741	785	1153	266	45
NC_025457.alt2	NC_025457.alt1	83.0619	307	5332	5638	3555	3846	255	52
NC_025457.alt2	NC_025457.alt1	89.1986	287	25968	26254	16055	16334	256	31
NC_025457.alt2	NC_025457.alt1	98.2394	284	22703	22986	14312	14595	279	5
NC_025457.alt2	NC_025457.alt1	83.2740	281	21046	21326	12822	13089	234	47
NC_025457.alt2	NC_025457.alt1	85.4093	281	29624	29904	18172	18438	240	41
NC_025457.alt2	NC_025457.alt1	86.1210	281	32820	33100	20296	20576	242	39
NC_025457.alt2	NC_025457.alt1	86.0714	280	52550	52829	33251	33526	241	39
NC_025457.alt2	NC_025457.alt1	98.5663	279	20209	20487	12245	12523	275	4
NC_025457.alt2	NC_025457.alt1	95.6522	276	10149	10424	6215	6490	264	12
NC_025457.alt2	NC_025457.alt1	97.3485	264	28443	28706	17463	17726	257	7
NC_025457.alt2	NC_025457.alt1	89.7338	263	63272	63534	40246	40508	236	27
NC_025457.alt2	NC_025457.alt1	94.1634	257	59089	59345	37746	38002	242	15
NC_025457.alt2	NC_025457.alt1	86	250	34274	34523	21056	21305	215	35
NC_025457.alt2	NC_025457.alt1	89.5582	249	290	538	140	388	223	26
NC_025457.alt2	NC_025457.alt1	91.9355	248	11206	11453	7453	7700	228	20
NC_025457.alt2	NC_025457.alt1	99.5935	246	12041	12286	31965	31720	245	1
NC_025457.alt2	NC_025457.alt1	91.0204	245	36340	36584	23009	23253	223	22
NC_025457.alt2	NC_025457.alt1	95.4918	244	42843	43086	27497	27740	233	11
NC_025457.alt2	NC_025457.alt1	90.4167	240	21656	21895	13489	13728	217	23
NC_025457.alt2	NC_025457.alt1	96.1702	235	27191	27425	16668	16902	226	9
NC_025457.alt2	NC_025457.alt1	88.8412	233	38840	39072	24315	24547	207	26
NC_025457.alt2	NC_025457.alt1	85.9649	228	43773	44000	27797	28006	196	32
NC_025457.alt2	NC_025457.alt1	87.1681	226	18580	18805	11170	11395	197	29
NC_025457.alt2	NC_025457.alt1	85.9091	220	2083	2302	1165	1357	189	31
NC_025457.alt2	NC_025457.alt1	96.3636	220	42623	42842	27434	27653	212	8
NC_025457.alt2	NC_025457.alt1	98.1395	215	55735	55949	35725	35939	211	4
NC_025457.alt2	NC_025457.alt1	90.1869	214	11827	12040	8157	8370	193	21
NC_025457.alt2	NC_025457.alt1	85.9813	214	53890	54103	34425	34636	184	30
NC_025457.alt2	NC_025457.alt1	80.5825	206	50723	50928	32684	32879	166	40
NC_025457.alt2	NC_025457.alt1	95.5882	204	19612	19815	11797	12000	195	9
NC_025457.alt2	NC_025457.alt1	98.4772	197	5915	6111	3847	4043	194	3
NC_025457.alt2	NC_025457.alt1	86.7347	196	45301	45496	28894	29089	170	26
NC_025457.alt2	NC_025457.alt1	83.5897	195	22119	22313	13813	13983	163	32
NC_025457.alt2	NC_025457.alt1	97.4359	195	55016	55210	35156	35350	190	5
NC_025457.alt2	NC_025457.alt1	86.9792	192	53698	53889	34192	34366	167	25
NC_025457.alt2	NC_025457.alt1	98.9189	185	8315	8499	29649	29833	183	2
NC_025457.alt2	NC_025457.alt1	89.7297	185	48014	48198	30612	30796	166	19
NC_025457.alt2	NC_025457.alt1	88.0435	184	22485	22668	14136	14308	162	22
NC_025457.alt2	NC_025457.alt1	87.9121	182	38046	38227	23663	23844	160	22
NC_025457.alt2	NC_025457.alt1	89.5604	182	56513	56694	36060	36241	163	19
NC_025457.alt2	NC_025457.alt1	88.5057	174	16550	16723	10286	10459	154	20
NC_025457.alt2	NC_025457.alt1	98.8372	172	6114	6285	3882	4053	170	2
NC_025457.alt2	NC_025457.alt1	94.7674	172	35361	35532	22104	22275	163	9
NC_025457.alt2	NC_025457.alt1	85.8824	170	38614	38783	24146	24315	146	24
NC_025457.alt2	NC_025457.alt1	90.5882	170	61368	61537	38752	38921	154	16
NC_025457.alt2	NC_025457.alt1	84.5238	168	7486	7653	4445	4612	142	26
NC_025457.alt2	NC_025457.alt1	86.3095	168	14593	14760	9020	9187	145	23
NC_025457.alt2	NC_025457.alt1	92.1212	165	40243	40407	25583	25747	152	13
NC_025457.alt2	NC_025457.alt1	91.4110	163	580	742	388	550	149	14
NC_025457.alt2	NC_025457.alt1	86.5031	163	16844	17006	10459	10621	141	22
NC_025457.alt2	NC_025457.alt1	85.8896	163	24593	24755	15247	15409	140	23
NC_025457.alt2	NC_025457.alt1	84.0491	163	39238	39400	24525	24687	137	26
NC_025457.alt2	NC_025457.alt1	98.7730	163	51955	52117	32974	33136	161	2
NC_025457.alt2	NC_025457.alt1	96.9136	162	23118	23279	14669	14830	157	5
NC_025457.alt2	NC_025457.alt1	93.7888	161	60502	60662	38457	38617	151	10
NC_025457.alt2	NC_025457.alt1	91.7722	158	32427	32584	20139	20296	145	13
NC_025457.alt2	NC_025457.alt1	87.0968	155	29168	29322	17845	17999	135	20
NC_025457.alt2	NC_025457.alt1	71.6129	155	57828	57982	36644	36782	111	44
NC_025457.alt2	NC_025457.alt1	90.9091	154	2318	2471	1619	1772	140	14
NC_025457.alt2	NC_025457.alt1	90.2597	154	15132	15285	9692	9845	139	15
NC_025457.alt2	NC_025457.alt1	98.7013	154	63631	63784	2807	2960	152	2
NC_025457.alt2	NC_025457.alt1	96.0784	153	1930	2082	1109	1261	147	6
NC_025457.alt2	NC_025457.alt1	81.6993	153	3461	3613	2336	2492	125	28
NC_025457.alt2	NC_025457.alt1	97.3684	152	33405	33556	20666	20817	148	4
NC_025457.alt2	NC_025457.alt1	96.0265	151	55212	55362	35448	35598	145	6
NC_025457.alt2	NC_025457.alt1	90.6667	150	60312	60461	38320	38469	136	14
NC_025457.alt2	NC_025457.alt1	89.1156	147	8500	8646	5397	5543	131	16
NC_025457.alt2	NC_025457.alt1	90.4110	146	60095	60240	38172	38317	132	14
NC_025457.alt2	NC_025457.alt1	93.7931	145	41134	41278	26372	26516	136	9
NC_025457.alt2	NC_025457.alt1	91.4894	141	2592	2732	1774	1914	129	12
NC_025457.alt2	NC_025457.alt1	89.2857	140	1	140	1	140	125	15
NC_025457.alt2	NC_025457.alt1	89.2086	139	38380	38518	24005	24143	124	15
NC_025457.alt2	NC_025457.alt1	80.1471	136	14043	14178	14679	14502	109	27
NC_025457.alt2	NC_025457.alt1	84.5588	136	24452	24587	14967	15102	115	21
NC_025457.alt2	NC_025457.alt1	88.8889	135	2860	2994	2079	2213	120	15
NC_025457.alt2	NC_025457.alt1	87.3134	134	35869	36002	22681	22548	117	17
NC_025457.alt2	NC_025457.alt1	99.2537	134	58955	59088	37733	37866	133	1
NC_025457.alt2	NC_025457.alt1	90.2256	133	48417	48549	30798	30930	120	13
NC_025457.alt2	NC_025457.alt1	88.5496	131	56875	57005	36443	36573	116	15
NC_025457.alt2	NC_025457.alt1	71.7557	131	63920	64050	40929	41048	94	37
NC_025457.alt2	NC_025457.alt1	99.2188	128	31120	31247	19138	19282	127	1
NC_025457.alt2	NC_025457.alt1	87.4016	127	1100	1226	655	781	111	16
NC_025457.alt2	NC_025457.alt1	90.4762	126	10536	10661	6742	6867	114	12
NC_025457.alt2	NC_025457.alt1	88.7097	124	9121	9244	5641	5764	110	14
NC_025457.alt2	NC_025457.alt1	1e+02	122	17900	18021	31081	31202	122	0
NC_025457.alt2	NC_025457.alt1	99.1803	122	41279	41400	26726	26847	121	1
NC_025457.alt2	NC_025457.alt1	88.4298	121	62674	62794	39688	39808	107	14
NC_025457.alt2	NC_025457.alt1	86.6667	120	3137	3256	2214	2333	104	16
NC_025457.alt2	NC_025457.alt1	99.1667	120	23297	23416	14711	14830	119	1
NC_025457.alt2	NC_025457.alt1	1e+02	119	39401	39519	24805	24687	119	0
NC_025457.alt2	NC_025457.alt1	1e+02	119	51836	51954	32965	33083	119	0
NC_025457.alt2	NC_025457.alt1	90.7563	119	58335	58453	36845	36995	108	11
NC_025457.alt2	NC_025457.alt1	98.2906	117	23785	23901	22087	21971	115	2
NC_025457.alt2	NC_025457.alt1	91.4530	117	40768	40884	25849	25965	107	10
NC_025457.alt2	NC_025457.alt1	99.1379	116	43657	43772	27766	27881	115	1
NC_025457.alt2	NC_025457.alt1	92.1053	114	59834	59947	38053	38166	105	9
NC_025457.alt2	NC_025457.alt1	90.2655	113	34161	34273	20872	20984	102	11
NC_025457.alt2	NC_025457.alt1	89.2857	112	47042	47153	29937	30077	100	12
NC_025457.alt2	NC_025457.alt1	88.2883	111	44184	44294	28045	28155	98	13
NC_025457.alt2	NC_025457.alt1	99.0909	110	20005	20114	12133	12242	109	1
NC_025457.alt2	NC_025457.alt1	88.0734	109	42384	42492	27323	27431	96	13
NC_025457.alt2	NC_025457.alt1	98.1651	109	61259	61367	38722	38614	107	2
NC_025457.alt2	NC_025457.alt1	89.8148	108	14923	15030	9581	9688	97	11
NC_025457.alt2	NC_025457.alt1	94.3925	107	12287	12393	8371	8477	101	6
NC_025457.alt2	NC_025457.alt1	86.7925	106	37013	37118	23481	23586	92	14
NC_025457.alt2	NC_025457.alt1	92.3810	105	10429	10533	6549	6653	97	8
NC_025457.alt2	NC_025457.alt1	88.5714	105	15797	15901	9980	10084	93	12
NC_025457.alt2	NC_025457.alt1	1e+02	104	19901	20004	11897	12000	104	0
NC_025457.alt2	NC_025457.alt1	89.4231	104	45019	45122	28418	28521	93	11
NC_025457.alt2	NC_025457.alt1	92.3077	104	58794	58897	37692	37589	96	8
NC_025457.alt2	NC_025457.alt1	91.2621	103	20894	20996	12724	12826	94	9
NC_025457.alt2	NC_025457.alt1	89.2157	102	901	1002	547	648	91	11
NC_025457.alt2	NC_025457.alt1	93.1373	102	13101	13202	8506	8607	95	7
NC_025457.alt2	NC_025457.alt1	87.2549	102	28831	28932	17743	17844	89	13
NC_025457.alt2	NC_025457.alt1	92.1569	102	58114	58215	36744	36845	94	8
NC_025457.alt2	NC_025457.alt1	83.3333	102	62398	62499	39087	39188	85	17
NC_025457.alt2	NC_025457.alt1	1e+02	101	34527	34627	21573	21473	101	0
NC_025457.alt2	NC_025457.alt1	89.1089	101	49450	49550	31968	32068	90	11
NC_025457.alt2	NC_025457.alt1	91.7526	97	7388	7484	4436	4340	89	8
NC_025457.alt2	NC_025457.alt1	91.7526	97	8881	8977	5543	5639	89	8
NC_025457.alt2	NC_025457.alt1	88.6598	97	18330	18426	10866	10962	86	11
NC_025457.alt2	NC_025457.alt1	88.5417	96	56264	56359	35964	36059	85	11
NC_025457.alt2	NC_025457.alt1	45.7447	94	26736	26829	7674	7745	43	51
NC_025457.alt2	NC_025457.alt1	91.4894	94	39523	39616	24810	24903	86	8
NC_025457.alt2	NC_025457.alt1	98.9362	94	54104	54197	18093	18000	93	1
NC_025457.alt2	NC_025457.alt1	90.2174	92	13336	13427	8611	8702	83	9
NC_025457.alt2	NC_025457.alt1	85.7143	91	38257	38347	23841	23931	78	13
NC_025457.alt2	NC_025457.alt1	1e+02	91	47617	47707	37241	37331	91	0
NC_025457.alt2	NC_025457.alt1	95.6044	91	52857	52947	33515	33605	87	4
NC_025457.alt2	NC_025457.alt1	92.2222	90	6699	6788	4174	4263	83	7
NC_025457.alt2	NC_025457.alt1	73.3333	90	46342	46431	29424	29535	66	24
NC_025457.alt2	NC_025457.alt1	1e+02	88	47708	47795	37413	37500	88	0
NC_025457.alt2	NC_025457.alt1	98.8636	88	58681	58768	37587	37500	87	1
NC_025457.alt2	NC_025457.alt1	91.9540	87	10905	10991	6895	6981	80	7
NC_025457.alt2	NC_025457.alt1	86.2069	87	63544	63630	40618	40532	75	12
NC_025457.alt2	NC_025457.alt1	87.2093	86	18022	18107	10780	10865	75	11
NC_025457.alt2	NC_025457.alt1	90.6977	86	20676	20761	12638	12723	78	8
NC_025457.alt2	NC_025457.alt1	88.3721	86	33233	33318	20577	20662	76	10
NC_025457.alt2	NC_025457.alt1	1e+02	86	45663	45748	11594	11679	86	0
NC_025457.alt2	NC_025457.alt1	83.7209	86	63807	63892	40624	40709	72	14
NC_025457.alt2	NC_025457.alt1	1e+02	85	19816	19900	12133	12217	85	0
NC_025457.alt2	NC_025457.alt1	1e+02	84	36671	36754	23392	23309	84	0
NC_025457.alt2	NC_025457.alt1	1e+02	83	33319	33401	32308	32226	83	0
NC_025457.alt2	NC_025457.alt1	86.5854	82	29325	29406	18096	18177	71	11
NC_025457.alt2	NC_025457.alt1	95.0617	81	35534	35614	22411	22491	77	4
NC_025457.alt2	NC_025457.alt1	91.3580	81	57700	57780	36575	36655	74	7
NC_025457.alt2	NC_025457.alt1	5e+01	80	12543	12622	23120	23191	40	40
NC_025457.alt2	NC_025457.alt1	1e+02	80	33579	33658	20738	20817	80	0
NC_025457.alt2	NC_025457.alt1	89.8734	79	36758	36836	23398	23476	71	8
NC_025457.alt2	NC_025457.alt1	92.4051	79	40408	40486	25821	25742	73	6
NC_025457.alt2	NC_025457.alt1	1e+02	79	49855	49933	32446	32368	79	0
NC_025457.alt2	NC_025457.alt1	93.5897	78	10992	11069	7051	7128	73	5
NC_025457.alt2	NC_025457.alt1	87.0130	77	8200	8276	5294	5370	67	10
NC_025457.alt2	NC_025457.alt1	96.1039	77	17387	17463	10624	10700	74	3
NC_025457.alt2	NC_025457.alt1	88.1579	76	30039	30114	18442	18517	67	9
NC_025457.alt2	NC_025457.alt1	64	75	13672	13746	8754	8821	48	27
NC_025457.alt2	NC_025457.alt1	91.7808	73	7308	7380	4267	4339	67	6
NC_025457.alt2	NC_025457.alt1	72.6027	73	16146	16218	10087	10163	53	20
NC_025457.alt2	NC_025457.alt1	89.0411	73	19063	19135	11680	11752	65	8
NC_025457.alt2	NC_025457.alt1	80.8219	73	31393	31465	19257	19329	59	14
NC_025457.alt2	NC_025457.alt1	95.8904	73	48550	48622	31011	31083	70	3
NC_025457.alt2	NC_025457.alt1	90.1408	71	37611	37681	23575	23645	64	7
NC_025457.alt2	NC_025457.alt1	94.3662	71	56800	56870	36242	36312	67	4
NC_025457.alt2	NC_025457.alt1	98.5714	70	48258	48327	30727	30796	69	1
NC_025457.alt2	NC_025457.alt1	89.7059	68	15633	15700	9907	9974	61	7
NC_025457.alt2	NC_025457.alt1	89.5522	67	18996	19062	11478	11544	60	7
NC_025457.alt2	NC_025457.alt1	92.4242	66	50177	50242	32436	32501	61	5
NC_025457.alt2	NC_025457.alt1	93.8462	65	4801	4865	3372	3436	61	4
NC_025457.alt2	NC_025457.alt1	87.6923	65	51327	51391	32882	32946	57	8
NC_025457.alt2	NC_025457.alt1	95.3846	65	62609	62673	39475	39539	62	3
NC_025457.alt2	NC_025457.alt1	53.125	64	14856	14919	23297	23202	34	30
NC_025457.alt2	NC_025457.alt1	85.7143	63	25157	25219	15863	15801	54	9
NC_025457.alt2	NC_025457.alt1	85.7143	63	36277	36339	22737	22799	54	9
NC_025457.alt2	NC_025457.alt1	91.9355	62	50036	50097	32436	32497	57	5
NC_025457.alt2	NC_025457.alt1	56.4516	62	59632	59693	3249	3192	35	27
NC_025457.alt2	NC_025457.alt1	88.7097	62	61977	62038	38995	39056	55	7
NC_025457.alt2	NC_025457.alt1	91.6667	60	61575	61634	38926	38985	55	5
NC_025457.alt2	NC_025457.alt1	42.3729	59	4449	4507	40365	40410	25	34
NC_025457.alt2	NC_025457.alt1	49.1525	59	44535	44593	2385	2478	29	30
NC_025457.alt2	NC_025457.alt1	84.7458	59	49756	49814	32175	32270	50	9
NC_025457.alt2	NC_025457.alt1	87.9310	58	15459	15516	9849	9906	51	7
NC_025457.alt2	NC_025457.alt1	96.4912	57	4197	4253	2961	3017	55	2
NC_025457.alt2	NC_025457.alt1	57.8947	57	19176	19232	14735	14641	33	24
NC_025457.alt2	NC_025457.alt1	96.4912	57	44381	44437	28309	28365	55	2
NC_025457.alt2	NC_025457.alt1	42.8571	56	4305	4360	17387	17341	24	32
NC_025457.alt2	NC_025457.alt1	91.0714	56	23988	24043	14831	14886	51	5
NC_025457.alt2	NC_025457.alt1	87.5	56	35813	35868	22491	22546	49	7
NC_025457.alt2	NC_025457.alt1	87.5	56	36615	36670	23255	23310	49	7
NC_025457.alt2	NC_025457.alt1	1e+02	55	52148	52202	33191	33137	55	0
NC_025457.alt2	NC_025457.alt1	94.5455	55	52388	52442	33194	33248	52	3
NC_025457.alt2	NC_025457.alt1	85.1852	54	33836	33889	20818	20871	46	8
NC_025457.alt2	NC_025457.alt1	90.5660	53	16301	16353	10230	10282	48	5
NC_025457.alt2	NC_025457.alt1	96.2264	53	30208	30260	18535	18587	51	2
NC_025457.alt2	NC_025457.alt1	94.3396	53	48628	48680	31209	31261	50	3
NC_025457.alt2	NC_025457.alt1	90.3846	52	59494	59545	38003	38054	47	5
NC_025457.alt2	NC_025457.alt1	90.1961	51	13482	13532	8701	8751	46	5
NC_025457.alt2	NC_025457.alt1	88.2353	51	46651	46701	29834	29884	45	6
NC_025457.alt2	NC_025457.alt1	88	50	22435	22484	14020	14069	44	6
NC_025457.alt2	NC_025457.alt1	88	50	36125	36174	22706	22755	44	6
NC_025457.alt2	NC_025457.alt1	9e+01	50	46830	46879	29884	29933	45	5
NC_025457.alt2	NC_025457.alt1	89.7959	49	50478	50526	32506	32554	44	5
NC_025457.alt2	NC_025457.alt1	62.5	48	1034	1081	40199	40250	30	18
NC_025457.alt2	NC_025457.alt1	58.3333	48	4716	4763	14230	14152	28	20
NC_025457.alt2	NC_025457.alt1	52.0833	48	5728	5775	30379	30340	25	23
NC_025457.alt2	NC_025457.alt1	91.6667	48	21504	21551	13441	13488	44	4
NC_025457.alt2	NC_025457.alt1	66.6667	48	49665	49712	2144	2236	32	16
NC_025457.alt2	NC_025457.alt1	54.1667	48	59969	60016	28743	28776	26	22
NC_025457.alt2	NC_025457.alt1	89.3617	47	44805	44851	28372	28418	42	5
NC_025457.alt2	NC_025457.alt1	55.3191	47	57185	57231	40959	40923	26	21
NC_025457.alt2	NC_025457.alt1	55.3191	47	57364	57410	40959	40923	26	21
NC_025457.alt2	NC_025457.alt1	64.4444	45	3294	3338	24831	24884	29	16
NC_025457.alt2	NC_025457.alt1	91.1111	45	21328	21372	13233	13277	41	4
NC_025457.alt2	NC_025457.alt1	86.3636	44	24832	24875	15394	15437	38	6
NC_025457.alt2	NC_025457.alt1	90.9091	44	40199	40242	25422	25465	40	4
NC_025457.alt2	NC_025457.alt1	90.9091	44	44295	44338	28265	28308	40	4
NC_025457.alt2	NC_025457.alt1	65.9091	44	50993	51036	12612	12579	29	15
NC_025457.alt2	NC_025457.alt1	88.6364	44	62217	62260	39059	39102	39	5
NC_025457.alt2	NC_025457.alt1	95.4545	44	64121	64164	41023	41066	42	2
NC_025457.alt2	NC_025457.alt1	86.0465	43	4574	4616	3035	3077	37	6
NC_025457.alt2	NC_025457.alt1	55.8140	43	17837	17879	41052	41016	24	19
NC_025457.alt2	NC_025457.alt1	66.6667	42	31596	31637	35299	35372	28	14
NC_025457.alt2	NC_025457.alt1	54.7619	42	61012	61053	35197	35262	23	19
NC_025457.alt2	NC_025457.alt1	90.2439	41	40926	40966	26335	26375	37	4
NC_025457.alt2	NC_025457.alt1	90.2439	41	46589	46629	29481	29521	37	4
NC_025457.alt2	NC_025457.alt1	73.1707	41	53407	53447	38722	38649	30	11
NC_025457.alt2	NC_025457.alt1	9e+01	40	44110	44149	28005	28044	36	4
NC_025457.alt2	NC_025457.alt1	9e+01	40	45261	45300	28741	28780	36	4
NC_025457.alt2	NC_025457.alt1	95	40	58899	58938	37692	37731	38	2
NC_025457.alt2	NC_025457.alt1	64.1026	39	15989	16027	28102	28175	25	14
NC_025457.alt2	NC_025457.alt1	82.0513	39	24142	24180	14887	14925	32	7
NC_025457.alt2	NC_025457.alt1	1e+02	39	45497	45535	11555	11593	39	0
NC_025457.alt2	NC_025457.alt1	1e+02	39	59751	59789	38053	38091	39	0
NC_025457.alt2	NC_025457.alt1	1e+02	37	19335	19371	11752	11788	37	0
NC_025457.alt2	NC_025457.alt1	54.0541	37	22398	22434	27781	27827	20	17
NC_025457.alt2	NC_025457.alt1	94.5946	37	62572	62608	39189	39225	35	2
NC_025457.alt2	NC_025457.alt1	97.2222	36	2796	2831	1915	1950	35	1
NC_025457.alt2	NC_025457.alt1	91.6667	36	21896	21931	13781	13816	33	3
NC_025457.alt2	NC_025457.alt1	63.8889	36	24296	24331	33425	33460	23	13
NC_025457.alt2	NC_025457.alt1	91.6667	36	25550	25585	15748	15713	33	3
NC_025457.alt2	NC_025457.alt1	61.1111	36	28792	28827	21335	21300	22	14
NC_025457.alt2	NC_025457.alt1	75	36	44740	44775	29577	29541	27	9
NC_025457.alt2	NC_025457.alt1	68.5714	35	55990	56024	5947	6015	24	11
NC_025457.alt2	NC_010807.alt2	49.6183	131	21254	21384	36979	36763	65	66
NC_025457.alt2	NC_010807.alt2	49.4505	91	40328	40418	35042	35115	45	46
NC_025457.alt2	NC_010807.alt2	63.5135	74	31479	31552	5233	5307	47	27
NC_025457.alt2	NC_010807.alt2	56.3380	71	36506	36576	17788	17888	40	31
NC_025457.alt2	NC_010807.alt2	60.2941	68	13960	14027	11221	11294	41	27
NC_025457.alt2	NC_010807.alt2	54.5455	66	5961	6026	27304	27213	36	30
NC_025457.alt2	NC_010807.alt2	54.5455	66	6125	6190	27304	27213	36	30
NC_025457.alt2	NC_010807.alt2	5e+01	66	19219	19284	15363	15313	33	33
NC_025457.alt2	NC_010807.alt2	54.5455	66	28202	28267	12221	12136	36	30
NC_025457.alt2	NC_010807.alt2	55.9322	59	13008	13066	36559	36473	33	26
NC_025457.alt2	NC_010807.alt2	45.7627	59	46853	46911	30818	30863	27	32
NC_025457.alt2	NC_010807.alt2	48.2759	58	31245	31302	29912	29962	28	30
NC_025457.alt2	NC_010807.alt2	61.4035	57	17239	17295	36711	36618	35	22
NC_025457.alt2	NC_010807.alt2	49.1228	57	19056	19112	19046	19001	28	29
NC_025457.alt2	NC_010807.alt2	47.3684	57	45810	45866	37738	37781	27	30
NC_025457.alt2	NC_010807.alt2	59.6491	57	58063	58119	36402	36354	34	23
NC_025457.alt2	NC_010807.alt2	66.0714	56	21634	21689	14505	14588	37	19
NC_025457.alt2	NC_010807.alt2	52.7273	55	30533	30587	20867	20812	29	26
NC_025457.alt2	NC_010807.alt2	47.2727	55	62576	62630	26084	26129	26	29
NC_025457.alt2	NC_010807.alt2	51.8519	54	2641	2694	27986	28031	28	26
NC_025457.alt2	NC_010807.alt2	54.9020	51	13087	13137	1016	1073	28	23
NC_025457.alt2	NC_010807.alt2	56.8627	51	26646	26696	16389	16478	29	22
NC_025457.alt2	NC_010807.alt2	5e+01	50	2704	2753	17097	17152	25	25
NC_025457.alt2	NC_010807.alt2	68	50	4974	5023	19668	19747	34	16
NC_025457.alt2	NC_010807.alt2	42	50	16560	16609	20075	20116	21	29
NC_025457.alt2	NC_010807.alt2	54	50	33524	33573	12421	12363	27	23
NC_025457.alt2	NC_010807.alt2	54	50	33626	33675	12421	12363	27	23
NC_025457.alt2	NC_010807.alt2	66	50	46930	46979	30611	30657	33	17
NC_025457.alt2	NC_010807.alt2	61.7021	47	39115	39161	39689	39628	29	18
NC_025457.alt2	NC_010807.alt2	63.8298	47	48565	48611	20127	20196	30	17
NC_025457.alt2	NC_010807.alt2	78.7234	47	57529	57575	22892	22857	37	10
NC_025457.alt2	NC_010807.alt2	78.2609	46	33075	33120	24994	24919	36	10
NC_025457.alt2	NC_010807.alt2	55.5556	45	28296	28340	19584	19621	25	20
NC_025457.alt2	NC_010807.alt2	55.5556	45	28467	28511	19584	19621	25	20
NC_025457.alt2	NC_010807.alt2	64.4444	45	36330	36374	10166	10207	29	16
NC_025457.alt2	NC_010807.alt2	55.5556	45	60036	60080	16146	16091	25	20
NC_025457.alt2	NC_010807.alt2	52.3810	42	27880	27921	16997	17028	22	20
NC_025457.alt2	NC_010807.alt2	66.6667	42	30161	30202	26875	26821	28	14
NC_025457.alt2	NC_010807.alt2	56.0976	41	6473	6513	8850	8900	23	18
NC_025457.alt2	NC_010807.alt2	56.0976	41	6633	6673	8850	8900	23	18
NC_025457.alt2	NC_010807.alt2	63.4146	41	42984	43024	10130	10099	26	15
NC_025457.alt2	NC_010807.alt2	7e+01	40	1743	1782	5101	5062	28	12
NC_025457.alt2	NC_010807.alt2	58.9744	39	10723	10761	13061	13104	23	16
NC_025457.alt2	NC_010807.alt2	66.6667	39	46123	46161	1636	1700	26	13
NC_025457.alt2	NC_010807.alt2	71.4286	35	26900	26934	39844	39785	25	10
NC_025457.alt2	NC_010807.alt2	68.5714	35	31442	31476	38015	37981	24	11
NC_025457.alt2	NC_010807.ref	51.1450	131	21254	21384	35412	35196	67	64
NC_025457.alt2	NC_010807.ref	49.4505	91	40328	40418	33475	33548	45	46
NC_025457.alt2	NC_010807.ref	60.7143	84	31469	31552	4945	5029	51	33
NC_025457.alt2	NC_010807.ref	56.3380	71	36506	36576	16844	16944	40	31
NC_025457.alt2	NC_010807.ref	60.2941	68	13960	14027	10525	10598	41	27
NC_025457.alt2	NC_010807.ref	54.5455	66	5961	6026	26271	26180	36	30
NC_025457.alt2	NC_010807.ref	54.5455	66	6125	6190	26271	26180	36	30
NC_025457.alt2	NC_010807.ref	5e+01	66	19219	19284	14574	14524	33	33
NC_025457.alt2	NC_010807.ref	54.5455	66	28202	28267	11525	11440	36	30
NC_025457.alt2	NC_010807.ref	44.6154	65	5626	5690	12324	12395	29	36
NC_025457.alt2	NC_010807.ref	54.2373	59	13008	13066	34992	34906	32	27
NC_025457.alt2	NC_010807.ref	47.4576	59	46853	46911	29693	29737	28	31
NC_025457.alt2	NC_010807.ref	43.1034	58	52520	52577	27622	27572	25	33
NC_025457.alt2	NC_010807.ref	61.4035	57	17239	17295	35144	35051	35	22
NC_025457.alt2	NC_010807.ref	49.1228	57	19056	19112	18102	18057	28	29
NC_025457.alt2	NC_010807.ref	47.3684	57	45810	45866	36171	36214	27	30
NC_025457.alt2	NC_010807.ref	59.6491	57	58063	58119	34835	34787	34	23
NC_025457.alt2	NC_010807.ref	60.7143	56	18450	18505	36510	36596	34	22
NC_025457.alt2	NC_010807.ref	66.0714	56	21634	21689	13809	13892	37	19
NC_025457.alt2	NC_010807.ref	52.7273	55	30533	30587	19923	19868	29	26
NC_025457.alt2	NC_010807.ref	47.2727	55	62576	62630	25051	25096	26	29
NC_025457.alt2	NC_010807.ref	51.8519	54	2641	2694	26953	26998	28	26
NC_025457.alt2	NC_010807.ref	57.6923	52	22304	22355	18133	18090	30	22
NC_025457.alt2	NC_010807.ref	54.9020	51	13087	13137	907	964	28	23
NC_025457.alt2	NC_010807.ref	56.8627	51	26646	26696	15600	15689	29	22
NC_025457.alt2	NC_010807.ref	5e+01	50	2704	2753	16308	16363	25	25
NC_025457.alt2	NC_010807.ref	56	50	4974	5023	18724	18803	28	22
NC_025457.alt2	NC_010807.ref	66	50	46930	46979	29486	29532	33	17
NC_025457.alt2	NC_010807.ref	56.25	48	31245	31292	28879	28962	27	21
NC_025457.alt2	NC_010807.ref	61.7021	47	39115	39161	37949	37888	29	18
NC_025457.alt2	NC_010807.ref	63.8298	47	48565	48611	19183	19252	30	17
NC_025457.alt2	NC_010807.ref	78.7234	47	57529	57575	21948	21913	37	10
NC_025457.alt2	NC_010807.ref	69.5652	46	43632	43677	20392	20463	32	14
NC_025457.alt2	NC_010807.ref	65.2174	46	60049	60094	23279	23222	30	16
NC_025457.alt2	NC_010807.ref	55.5556	45	28296	28340	18640	18677	25	20
NC_025457.alt2	NC_010807.ref	55.5556	45	28467	28511	18640	18677	25	20
NC_025457.alt2	NC_010807.ref	64.4444	45	36330	36374	9470	9511	29	16
NC_025457.alt2	NC_010807.ref	6e+01	45	37016	37060	429	475	27	18
NC_025457.alt2	NC_010807.ref	52.3810	42	27880	27921	16208	16239	22	20
NC_025457.alt2	NC_010807.ref	66.6667	42	30161	30202	25842	25788	28	14
NC_025457.alt2	NC_010807.ref	58.5366	41	6473	6513	8154	8204	24	17
NC_025457.alt2	NC_010807.ref	58.5366	41	6633	6673	8154	8204	24	17
NC_025457.alt2	NC_010807.ref	7e+01	40	1743	1782	4823	4784	28	12
NC_025457.alt2	NC_010807.ref	62.5	40	60956	60995	32659	32600	25	15
NC_025457.alt2	NC_010807.ref	66.6667	39	46123	46161	1527	1591	26	13
NC_025457.alt2	NC_010807.ref	65.7143	35	61971	62005	31013	30959	23	12
NC_025457.alt2	NC_010807.alt3	51.1450	131	21254	21384	35998	35782	67	64
NC_025457.alt2	NC_010807.alt3	50.5618	89	22820	22908	24514	24424	45	44
NC_025457.alt2	NC_010807.alt3	60.7143	84	31469	31552	5382	5466	51	33
NC_025457.alt2	NC_010807.alt3	60.2941	68	13960	14027	10741	10814	41	27
NC_025457.alt2	NC_010807.alt3	54.5455	66	5961	6026	26508	26417	36	30
NC_025457.alt2	NC_010807.alt3	54.5455	66	6125	6190	26508	26417	36	30
NC_025457.alt2	NC_010807.alt3	5e+01	66	19219	19284	14627	14577	33	33
NC_025457.alt2	NC_010807.alt3	54.5455	66	28202	28267	11741	11656	36	30
NC_025457.alt2	NC_010807.alt3	44.6154	65	5626	5690	12445	12516	29	36
NC_025457.alt2	NC_010807.alt3	54.0984	61	62345	62405	15249	15293	33	28
NC_025457.alt2	NC_010807.alt3	47.4576	59	46853	46911	29945	29989	28	31
NC_025457.alt2	NC_010807.alt3	43.1034	58	52520	52577	27761	27711	25	33
NC_025457.alt2	NC_010807.alt3	47.3684	57	45810	45866	36969	37012	27	30
NC_025457.alt2	NC_010807.alt3	59.6491	57	58063	58119	35527	35479	34	23
NC_025457.alt2	NC_010807.alt3	52.7273	55	30533	30587	20244	20189	29	26
NC_025457.alt2	NC_010807.alt3	50.9091	55	50752	50806	7056	7101	28	27
NC_025457.alt2	NC_010807.alt3	47.2727	55	62576	62630	3401	3356	26	29
NC_025457.alt2	NC_010807.alt3	51.8519	54	2641	2694	27092	27137	28	26
NC_025457.alt2	NC_010807.alt3	56.8627	51	26646	26696	15853	15942	29	22
NC_025457.alt2	NC_010807.alt3	5e+01	50	2704	2753	16561	16616	25	25
NC_025457.alt2	NC_010807.alt3	56	50	4974	5023	19371	19450	28	22
NC_025457.alt2	NC_010807.alt3	66	50	46930	46979	29463	29509	33	17
NC_025457.alt2	NC_010807.alt3	56.25	48	31245	31292	28856	28939	27	21
NC_025457.alt2	NC_010807.alt3	62.5	48	33935	33982	33128	33199	30	18
NC_025457.alt2	NC_010807.alt3	56.25	48	53260	53307	19094	19018	27	21
NC_025457.alt2	NC_010807.alt3	78.7234	47	57529	57575	22378	22343	37	10
NC_025457.alt2	NC_010807.alt3	69.5652	46	43632	43677	20713	20784	32	14
NC_025457.alt2	NC_010807.alt3	65.2174	46	60049	60094	23709	23652	30	16
NC_025457.alt2	NC_010807.alt3	55.5556	45	28296	28340	19287	19324	25	20
NC_025457.alt2	NC_010807.alt3	55.5556	45	28467	28511	19287	19324	25	20
NC_025457.alt2	NC_010807.alt3	64.4444	45	36330	36374	9686	9727	29	16
NC_025457.alt2	NC_010807.alt3	6e+01	45	37016	37060	645	691	27	18
NC_025457.alt2	NC_010807.alt3	53.4884	43	27879	27921	16460	16492	23	20
NC_025457.alt2	NC_010807.alt3	55.8140	43	31295	31337	10777	10832	24	19
NC_025457.alt2	NC_010807.alt3	66.6667	42	30161	30202	26079	26025	28	14
NC_025457.alt2	NC_010807.alt3	58.5366	41	6473	6513	8232	8282	24	17
NC_025457.alt2	NC_010807.alt3	58.5366	41	6633	6673	8232	8282	24	17
NC_025457.alt2	NC_010807.alt3	7e+01	40	1743	1782	5260	5221	28	12
NC_025457.alt2	NC_010807.alt3	62.5	40	60956	60995	32911	32852	25	15
NC_025457.alt2	NC_010807.alt3	66.6667	39	46123	46161	1945	2009	26	13
NC_025457.alt2	NC_010807.alt3	74.2857	35	542	576	245	317	26	9
NC_025457.alt2	NC_010807.alt3	65.7143	35	61971	62005	31265	31211	23	12
NC_025457.alt2	NC_002486.ref	60.9375	64	34230	34293	15483	15388	39	25
NC_025457.alt2	NC_002486.ref	49.1525	59	58517	58575	19716	19620	29	30
NC_025457.alt2	NC_002486.ref	53.4483	58	506	563	31229	31273	31	27
NC_025457.alt2	NC_002486.ref	51.7241	58	22496	22553	19979	19897	30	28
NC_025457.alt2	NC_002486.ref	59.6491	57	42995	43051	28793	28870	34	23
NC_025457.alt2	NC_002486.ref	60.7143	56	38092	38147	19776	19841	34	22
NC_025457.alt2	NC_002486.ref	43.3962	53	15064	15116	3964	3919	23	30
NC_025457.alt2	NC_002486.ref	55.7692	52	16832	16883	15847	15920	29	23
NC_025457.alt2	NC_002486.ref	61.5385	52	18188	18239	3271	3228	32	20
NC_025457.alt2	NC_002486.ref	67.3077	52	28607	28658	26419	26509	35	17
NC_025457.alt2	NC_002486.ref	51.9231	52	28773	28824	34658	34701	27	25
NC_025457.alt2	NC_002486.ref	59.6154	52	33766	33817	41529	41488	31	21
NC_025457.alt2	NC_002486.ref	50.9804	51	42630	42680	33767	33814	26	25
NC_025457.alt2	NC_002486.ref	54.9020	51	52824	52874	34145	34230	28	23
NC_025457.alt2	NC_002486.ref	6e+01	50	11128	11177	13595	13560	30	20
NC_025457.alt2	NC_002486.ref	64	50	57265	57314	1709	1624	32	18
NC_025457.alt2	NC_002486.ref	64	50	57444	57493	1709	1624	32	18
NC_025457.alt2	NC_002486.ref	59.1837	49	25831	25879	31253	31319	29	20
NC_025457.alt2	NC_002486.ref	59.1837	49	26010	26058	31253	31319	29	20
NC_025457.alt2	NC_002486.ref	57.1429	49	39229	39277	22874	22957	28	21
NC_025457.alt2	NC_002486.ref	64.5833	48	41189	41236	21909	21964	31	17
NC_025457.alt2	NC_002486.ref	71.1111	45	4666	4710	15856	15922	32	13
NC_025457.alt2	NC_002486.ref	64.4444	45	19302	19346	21380	21313	29	16
NC_025457.alt2	NC_002486.ref	52.2727	44	937	980	237	202	23	21
NC_025457.alt2	NC_002486.ref	68.1818	44	46630	46673	22574	22604	30	14
NC_025457.alt2	NC_002486.ref	56.8182	44	62995	63038	11116	11194	25	19
NC_025457.alt2	NC_002486.ref	69.0476	42	11838	11879	13629	13693	29	13
NC_025457.alt2	NC_002486.ref	59.5238	42	52249	52290	43314	43394	25	17
NC_025457.alt2	NC_002486.ref	56.0976	41	14496	14536	764	843	23	18
NC_025457.alt2	NC_002486.ref	67.5	40	11927	11966	11985	11934	27	13
NC_025457.alt2	NC_002486.ref	7e+01	40	43973	44012	40774	40737	28	12
NC_025457.alt2	NC_002486.ref	69.2308	39	8620	8658	9281	9234	27	12
NC_025457.alt2	NC_002486.ref	65.7895	38	3404	3441	35338	35273	25	13
NC_025457.alt2	NC_002486.ref	63.1579	38	21166	21203	35605	35546	24	14
NC_025457.alt2	NC_002486.ref	71.0526	38	26529	26566	15080	15117	27	11
NC_025457.alt2	NC_002486.ref	80.5556	36	3214	3249	21567	21527	29	7
NC_025457.alt2	NC_002486.ref	57.1429	35	18861	18895	20534	20561	20	15
NC_025457.alt2	NC_002486.ref	57.1429	35	24934	24968	36160	36186	20	15
NC_025457.alt2	NC_002486.ref	74.2857	35	29173	29207	15937	15896	26	9
NC_025457.alt2	NC_002486.alt	60.9375	64	34230	34293	30154	30249	39	25
NC_025457.alt2	NC_002486.alt	59.3220	59	39659	39717	10036	10128	35	24
NC_025457.alt2	NC_002486.alt	49.1525	59	58517	58575	25921	26017	29	30
NC_025457.alt2	NC_002486.alt	53.4483	58	506	563	805	849	31	27
NC_025457.alt2	NC_002486.alt	51.7241	58	22496	22553	25658	25740	30	28
NC_025457.alt2	NC_002486.alt	59.6491	57	42995	43051	16844	16767	34	23
NC_025457.alt2	NC_002486.alt	60.7143	56	38092	38147	25861	25796	34	22
NC_025457.alt2	NC_002486.alt	43.3962	53	15064	15116	34388	34343	23	30
NC_025457.alt2	NC_002486.alt	55.7692	52	16832	16883	29790	29717	29	23
NC_025457.alt2	NC_002486.alt	61.5385	52	18188	18239	33695	33652	32	20
NC_025457.alt2	NC_002486.alt	67.3077	52	28607	28658	19218	19128	35	17
NC_025457.alt2	NC_002486.alt	51.9231	52	28773	28824	4234	4277	27	25
NC_025457.alt2	NC_002486.alt	59.6154	52	33766	33817	11105	11064	31	21
NC_025457.alt2	NC_002486.alt	63.4615	52	40949	41000	13189	13273	33	19
NC_025457.alt2	NC_002486.alt	50.9804	51	42630	42680	3343	3390	26	25
NC_025457.alt2	NC_002486.alt	54.9020	51	52824	52874	3721	3806	28	23
NC_025457.alt2	NC_002486.alt	6e+01	50	11128	11177	44019	43984	30	20
NC_025457.alt2	NC_002486.alt	64	50	57265	57314	32133	32048	32	18
NC_025457.alt2	NC_002486.alt	64	50	57444	57493	32133	32048	32	18
NC_025457.alt2	NC_002486.alt	59.1837	49	25831	25879	829	895	29	20
NC_025457.alt2	NC_002486.alt	59.1837	49	26010	26058	829	895	29	20
NC_025457.alt2	NC_002486.alt	57.1429	49	39229	39277	22763	22680	28	21
NC_025457.alt2	NC_002486.alt	64.5833	48	41189	41236	23728	23673	31	17
NC_025457.alt2	NC_002486.alt	71.1111	45	4666	4710	29781	29715	32	13
NC_025457.alt2	NC_002486.alt	64.4444	45	19302	19346	24257	24324	29	16
NC_025457.alt2	NC_002486.alt	52.2727	44	937	980	30661	30626	23	21
NC_025457.alt2	NC_002486.alt	68.1818	44	46630	46673	23063	23033	30	14
NC_025457.alt2	NC_002486.alt	56.8182	44	62995	63038	41540	41618	25	19
NC_025457.alt2	NC_002486.alt	69.0476	42	11838	11879	44053	44117	29	13
NC_025457.alt2	NC_002486.alt	59.5238	42	52249	52290	12890	12970	25	17
NC_025457.alt2	NC_002486.alt	56.0976	41	14496	14536	31188	31267	23	18
NC_025457.alt2	NC_002486.alt	67.5	40	11927	11966	42409	42358	27	13
NC_025457.alt2	NC_002486.alt	7e+01	40	43973	44012	10350	10313	28	12
NC_025457.alt2	NC_002486.alt	69.2308	39	8620	8658	39705	39658	27	12
NC_025457.alt2	NC_002486.alt	65.7895	38	3404	3441	4914	4849	25	13
NC_025457.alt2	NC_002486.alt	63.1579	38	21166	21203	5181	5122	24	14
NC_025457.alt2	NC_002486.alt	71.0526	38	26529	26566	45504	45541	27	11
NC_025457.alt2	NC_002486.alt	80.5556	36	3214	3249	24070	24110	29	7
NC_025457.alt2	NC_002486.alt	57.1429	35	18861	18895	25103	25076	20	15
NC_025457.alt2	NC_002486.alt	57.1429	35	24934	24968	5736	5762	20	15
NC_025457.alt2	NC_002486.alt	74.2857	35	29173	29207	29700	29741	26	9
NC_005091.alt2	NC_025457.ref	5e+01	74	32943	33016	1797	1903	37	37
NC_005091.alt2	NC_025457.ref	58.2090	67	41664	41730	23718	23629	39	28
NC_005091.alt2	NC_025457.ref	51.5625	64	53724	53787	19170	19271	33	31
NC_005091.alt2	NC_025457.ref	53.4483	58	52630	52687	2735	2821	31	27
NC_005091.alt2	NC_025457.ref	46.4286	56	62170	62225	28681	28633	26	30
NC_005091.alt2	NC_025457.ref	52.7273	55	9785	9839	29138	29182	29	26
NC_005091.alt2	NC_025457.ref	52.7273	55	38524	38578	24667	24743	29	26
NC_005091.alt2	NC_025457.ref	55.5556	54	885	938	38718	38792	30	24
NC_005091.alt2	NC_025457.ref	65.3846	52	33709	33760	7857	7947	34	18
NC_005091.alt2	NC_025457.ref	40.3846	52	62268	62319	1706	1664	21	31
NC_005091.alt2	NC_025457.ref	56.8627	51	24157	24207	40097	40139	29	22
NC_005091.alt2	NC_025457.ref	47.0588	51	60578	60628	41873	41832	24	27
NC_005091.alt2	NC_025457.ref	64	50	19941	19990	17947	17990	32	18
NC_005091.alt2	NC_025457.ref	57.4468	47	10326	10372	32822	32782	27	20
NC_005091.alt2	NC_025457.ref	48.9362	47	36003	36049	40566	40529	23	24
NC_005091.alt2	NC_025457.ref	66.6667	45	748	792	15984	16047	30	15
NC_005091.alt2	NC_025457.ref	59.0909	44	37236	37279	27485	27418	26	18
NC_005091.alt2	NC_025457.ref	58.5366	41	25141	25181	26350	26381	24	17
NC_005091.alt2	NC_025457.ref	6e+01	40	31425	31464	39585	39618	24	16
NC_005091.alt2	NC_025457.ref	56.4103	39	16672	16710	3749	3776	22	17
NC_005091.alt2	NC_025457.ref	67.5676	37	49007	49043	6499	6535	25	12
NC_005091.alt2	NC_025457.ref	65.7143	35	24573	24607	20745	20809	23	12
NC_005091.alt2	NC_025457.alt1	49.0385	104	60174	60277	40691	40785	51	53
NC_005091.alt2	NC_025457.alt1	66.1972	71	14685	14755	30190	30066	47	24
NC_005091.alt2	NC_025457.alt1	60.6557	61	52122	52182	9341	9456	37	24
NC_005091.alt2	NC_025457.alt1	59.6491	57	42341	42397	38215	38161	34	23
NC_005091.alt2	NC_025457.alt1	46.4286	56	62170	62225	27637	27589	26	30
NC_005091.alt2	NC_025457.alt1	52.7273	55	9785	9839	27876	27920	29	26
NC_005091.alt2	NC_025457.alt1	55.5556	54	18943	18996	26269	26177	30	24
NC_005091.alt2	NC_025457.alt1	55.5556	54	19134	19187	26269	26177	30	24
NC_005091.alt2	NC_025457.alt1	65.3846	52	33709	33760	7554	7644	34	18
NC_005091.alt2	NC_025457.alt1	40.3846	52	62268	62319	1824	1782	21	31
NC_005091.alt2	NC_025457.alt1	56.8627	51	4939	4989	13419	13371	29	22
NC_005091.alt2	NC_025457.alt1	64	50	19941	19990	17052	17095	32	18
NC_005091.alt2	NC_025457.alt1	46	50	33068	33117	22105	22065	23	27
NC_005091.alt2	NC_025457.alt1	64.5833	48	9550	9597	19440	19342	31	17
NC_005091.alt2	NC_025457.alt1	52.0833	48	43279	43326	4115	4158	25	23
NC_005091.alt2	NC_025457.alt1	57.4468	47	10326	10372	31663	31623	27	20
NC_005091.alt2	NC_025457.alt1	48.9362	47	36003	36049	38532	38495	23	24
NC_005091.alt2	NC_025457.alt1	60.8696	46	39303	39348	23470	23550	28	18
NC_005091.alt2	NC_025457.alt1	54.3478	46	41746	41791	15039	15100	25	21
NC_005091.alt2	NC_025457.alt1	47.8261	46	54248	54293	7033	7070	22	24
NC_005091.alt2	NC_025457.alt1	6e+01	45	62628	62672	36999	36918	27	18
NC_005091.alt2	NC_025457.alt1	63.4146	41	931	971	38866	38820	26	15
NC_005091.alt2	NC_025457.alt1	58.5366	41	25141	25181	25167	25198	24	17
NC_005091.alt2	NC_025457.alt1	6e+01	40	31425	31464	37953	37986	24	16
NC_005091.alt2	NC_025457.alt1	66.6667	39	54451	54489	26226	26175	26	13
NC_005091.alt2	NC_025457.alt1	75	36	26213	26248	26159	26132	27	9
NC_005091.alt2	NC_025457.alt1	66.6667	36	35276	35311	30058	30023	24	12
NC_005091.alt2	NC_010807.alt1	51.8072	83	61107	61189	20668	20768	43	40
NC_005091.alt2	NC_010807.alt1	53.5211	71	54374	54444	12055	11947	38	33
NC_005091.alt2	NC_010807.alt1	57.1429	70	151	220	2472	2390	40	30
NC_005091.alt2	NC_010807.alt1	55.2239	67	28485	28551	20936	20849	37	30
NC_005091.alt2	NC_010807.alt1	65.1515	66	21819	21884	18341	18431	43	23
NC_005091.alt2	NC_010807.alt1	65.1515	66	22017	22082	18341	18431	43	23
NC_005091.alt2	NC_010807.alt1	68.75	64	52647	52710	26497	26396	44	20
NC_005091.alt2	NC_010807.alt1	53.2258	62	46289	46350	26699	26764	33	29
NC_005091.alt2	NC_010807.alt1	54.0984	61	3124	3184	30507	30560	33	28
NC_005091.alt2	NC_010807.alt1	50.8475	59	36409	36467	7468	7513	30	29
NC_005091.alt2	NC_010807.alt1	53.4483	58	53728	53785	8827	8742	31	27
NC_005091.alt2	NC_010807.alt1	66.6667	57	36202	36258	21030	20957	38	19
NC_005091.alt2	NC_010807.alt1	50.9091	55	17454	17508	24067	24104	28	27
NC_005091.alt2	NC_010807.alt1	4e+01	55	27526	27580	25197	25151	22	33
NC_005091.alt2	NC_010807.alt1	67.2727	55	50964	51018	21843	21777	37	18
NC_005091.alt2	NC_010807.alt1	67.2727	55	51089	51143	21843	21777	37	18
NC_005091.alt2	NC_010807.alt1	54.7170	53	8353	8405	2871	2786	29	24
NC_005091.alt2	NC_010807.alt1	61.5385	52	3641	3692	29948	29873	32	20
NC_005091.alt2	NC_010807.alt1	55.7692	52	4854	4905	9423	9379	29	23
NC_005091.alt2	NC_010807.alt1	5e+01	52	45473	45524	29402	29359	26	26
NC_005091.alt2	NC_010807.alt1	56.8627	51	49227	49277	1952	1878	29	22
NC_005091.alt2	NC_010807.alt1	56.8627	51	61757	61807	31151	31194	29	22
NC_005091.alt2	NC_010807.alt1	64	50	25830	25879	23281	23353	32	18
NC_005091.alt2	NC_010807.alt1	61.2245	49	47281	47329	15398	15351	30	19
NC_005091.alt2	NC_010807.alt1	53.0612	49	57149	57197	20674	20641	26	23
NC_005091.alt2	NC_010807.alt1	55.1020	49	60773	60821	6219	6146	27	22
NC_005091.alt2	NC_010807.alt1	69.5652	46	2303	2348	37798	37876	32	14
NC_005091.alt2	NC_010807.alt1	51.1111	45	1638	1682	30480	30525	23	22
NC_005091.alt2	NC_010807.alt1	54.5455	44	45843	45886	10549	10580	24	20
NC_005091.alt2	NC_010807.alt1	69.7674	43	8007	8049	22537	22583	30	13
NC_005091.alt2	NC_010807.alt1	69.0476	42	3379	3420	38241	38291	29	13
NC_005091.alt2	NC_010807.alt1	54.7619	42	24094	24135	15558	15635	23	19
NC_005091.alt2	NC_010807.alt1	65	40	5559	5598	15450	15393	26	14
NC_005091.alt2	NC_010807.alt1	55.2632	38	48738	48775	36489	36461	21	17
NC_005091.alt2	NC_010807.alt1	64.8649	37	19730	19766	25574	25503	24	13
NC_005091.alt2	NC_010807.alt1	72.9730	37	54966	55002	32531	32567	27	10
NC_005091.alt2	NC_010807.alt1	77.7778	36	31059	31094	21723	21668	28	8
NC_005091.alt2	NC_010807.alt1	88.8889	36	61225	61260	1655	1624	32	4
NC_005091.alt2	NC_010807.alt1	71.4286	35	11769	11803	36889	36958	25	10
NC_005091.alt2	NC_010807.alt1	74.2857	35	60678	60712	16704	16753	26	9
NC_005091.alt2	NC_010807.alt2	51.8072	83	61107	61189	21612	21712	43	40
NC_005091.alt2	NC_010807.alt2	53.5211	71	54374	54444	13313	13205	38	33
NC_005091.alt2	NC_010807.alt2	57.1429	70	151	220	3196	3114	40	30
NC_005091.alt2	NC_010807.alt2	52.1739	69	33986	34054	15444	15367	36	33
NC_005091.alt2	NC_010807.alt2	65.1515	66	21819	21884	19401	19491	43	23
NC_005091.alt2	NC_010807.alt2	65.1515	66	22017	22082	19401	19491	43	23
NC_005091.alt2	NC_010807.alt2	68.75	64	52647	52710	27530	27429	44	20
NC_005091.alt2	NC_010807.alt2	60.9375	64	62312	62375	2614	2690	39	25
NC_005091.alt2	NC_010807.alt2	53.2258	62	46289	46350	27732	27797	33	29
NC_005091.alt2	NC_010807.alt2	54.0984	61	3124	3184	31818	31871	33	28
NC_005091.alt2	NC_010807.alt2	54.0984	61	57625	57685	32284	32214	33	28
NC_005091.alt2	NC_010807.alt2	53.4483	58	21052	21109	29808	29854	31	27
NC_005091.alt2	NC_010807.alt2	54.3860	57	2366	2422	776	816	31	26
NC_005091.alt2	NC_010807.alt2	66.6667	57	36202	36258	21974	21901	38	19
NC_005091.alt2	NC_010807.alt2	50.9091	55	17454	17508	25100	25137	28	27
NC_005091.alt2	NC_010807.alt2	52.8302	53	8353	8405	3775	3690	28	25
NC_005091.alt2	NC_010807.alt2	61.5385	52	3641	3692	31259	31184	32	20
NC_005091.alt2	NC_010807.alt2	58.8235	51	49227	49277	2507	2433	30	21
NC_005091.alt2	NC_010807.alt2	54.9020	51	49652	49702	18565	18503	28	23
NC_005091.alt2	NC_010807.alt2	58.8235	51	61757	61807	32462	32505	30	21
NC_005091.alt2	NC_010807.alt2	64	50	25830	25879	24314	24386	32	18
NC_005091.alt2	NC_010807.alt2	61.2245	49	47281	47329	16465	16418	30	19
NC_005091.alt2	NC_010807.alt2	53.0612	49	57149	57197	21618	21585	26	23
NC_005091.alt2	NC_010807.alt2	55.1020	49	60773	60821	7431	7358	27	22
NC_005091.alt2	NC_010807.alt2	51.1111	45	1638	1682	31791	31836	23	22
NC_005091.alt2	NC_010807.alt2	64.4444	45	26907	26951	18657	18739	29	16
NC_005091.alt2	NC_010807.alt2	66.6667	45	57993	58037	36290	36220	30	15
NC_005091.alt2	NC_010807.alt2	54.5455	44	45843	45886	11987	12018	24	20
NC_005091.alt2	NC_010807.alt2	69.7674	43	8007	8049	23481	23527	30	13
NC_005091.alt2	NC_010807.alt2	67.4419	43	48039	48081	6476	6549	29	14
NC_005091.alt2	NC_010807.alt2	69.0476	42	3379	3420	39981	40031	29	13
NC_005091.alt2	NC_010807.alt2	65	40	5559	5598	16517	16460	26	14
NC_005091.alt2	NC_010807.alt2	65	40	23470	23509	17566	17620	26	14
NC_005091.alt2	NC_010807.alt2	57.5	40	28512	28551	22737	22705	23	17
NC_005091.alt2	NC_010807.alt2	8e+01	40	50034	50073	5889	5858	32	8
NC_005091.alt2	NC_010807.alt2	55.2632	38	48738	48775	38229	38201	21	17
NC_005091.alt2	NC_010807.alt2	64.8649	37	19730	19766	26607	26536	24	13
NC_005091.alt2	NC_010807.alt2	67.5676	37	35630	35666	29441	29405	25	12
NC_005091.alt2	NC_010807.alt2	67.5676	37	54966	55002	33842	33878	25	12
NC_005091.alt2	NC_010807.alt2	69.4444	36	13497	13532	11068	11131	25	11
NC_005091.alt2	NC_010807.alt2	75	36	31059	31094	22667	22612	27	9
NC_005091.alt2	NC_010807.alt2	71.4286	35	11769	11803	38629	38698	25	10
NC_005091.alt2	NC_010807.alt2	62.8571	35	25880	25914	39533	39559	22	13
NC_005091.alt2	NC_010807.alt2	71.4286	35	60678	60712	17764	17813	25	10
NC_005091.alt2	NC_002486.ref	52	75	45094	45168	21829	21733	39	36
NC_005091.alt2	NC_002486.ref	5e+01	56	46259	46314	11272	11224	28	28
NC_005091.alt2	NC_002486.ref	52	50	13331	13380	18961	19038	26	24
NC_005091.alt2	NC_002486.ref	55.1020	49	32319	32367	26270	26230	27	22
NC_005091.alt2	NC_002486.ref	5e+01	48	7609	7656	42153	42222	24	24
NC_005091.alt2	NC_002486.ref	56.8182	44	28724	28767	23708	23744	25	19
NC_005091.alt2	NC_002486.ref	52.2727	44	62692	62735	3624	3593	23	21
NC_005091.alt2	NC_002486.ref	71.7949	39	51881	51919	12539	12470	28	11
NC_005091.alt2	NC_002486.ref	63.1579	38	54156	54193	24863	24824	24	14
NC_005091.alt2	NC_002486.ref	63.1579	38	54303	54340	24863	24824	24	14
NC_005091.alt2	NC_002486.ref	64.8649	37	48166	48202	26538	26499	24	13
NC_005091.alt2	NC_002486.ref	62.1622	37	61131	61167	40607	40578	23	14
NC_005091.alt2	NC_010807.ref	51.8072	83	61107	61189	20668	20768	43	40
NC_005091.alt2	NC_010807.ref	53.5211	71	54374	54444	12617	12509	38	33
NC_005091.alt2	NC_010807.ref	57.1429	70	151	220	2918	2836	40	30
NC_005091.alt2	NC_010807.ref	55.2239	67	28485	28551	20936	20849	37	30
NC_005091.alt2	NC_010807.ref	65.1515	66	21819	21884	18457	18547	43	23
NC_005091.alt2	NC_010807.ref	65.1515	66	22017	22082	18457	18547	43	23
NC_005091.alt2	NC_010807.ref	68.75	64	52647	52710	26497	26396	44	20
NC_005091.alt2	NC_010807.ref	60.9375	64	62312	62375	2505	2581	39	25
NC_005091.alt2	NC_010807.ref	53.2258	62	46289	46350	26699	26764	33	29
NC_005091.alt2	NC_010807.ref	54.0984	61	3124	3184	30507	30560	33	28
NC_005091.alt2	NC_010807.ref	50.8475	59	36409	36467	8094	8139	30	29
NC_005091.alt2	NC_010807.ref	66.6667	57	36202	36258	21030	20957	38	19
NC_005091.alt2	NC_010807.ref	50.9091	55	17454	17508	24067	24104	28	27
NC_005091.alt2	NC_010807.ref	4e+01	55	27526	27580	25197	25151	22	33
NC_005091.alt2	NC_010807.ref	67.2727	55	50964	51018	21843	21777	37	18
NC_005091.alt2	NC_010807.ref	67.2727	55	51089	51143	21843	21777	37	18
NC_005091.alt2	NC_010807.ref	54.7170	53	8353	8405	3497	3412	29	24
NC_005091.alt2	NC_010807.ref	61.5385	52	3641	3692	29948	29873	32	20
NC_005091.alt2	NC_010807.ref	55.7692	52	4854	4905	10049	10005	29	23
NC_005091.alt2	NC_010807.ref	5e+01	52	45473	45524	29402	29359	26	26
NC_005091.alt2	NC_010807.ref	58.8235	51	49227	49277	2398	2324	30	21
NC_005091.alt2	NC_010807.ref	56.8627	51	61757	61807	31151	31194	29	22
NC_005091.alt2	NC_010807.ref	64	50	25830	25879	23281	23353	32	18
NC_005091.alt2	NC_010807.ref	61.2245	49	47281	47329	15676	15629	30	19
NC_005091.alt2	NC_010807.ref	53.0612	49	57149	57197	20674	20641	26	23
NC_005091.alt2	NC_010807.ref	55.1020	49	60773	60821	6845	6772	27	22
NC_005091.alt2	NC_010807.ref	51.1111	45	1638	1682	30480	30525	23	22
NC_005091.alt2	NC_010807.ref	66.6667	45	57993	58037	34723	34653	30	15
NC_005091.alt2	NC_010807.ref	54.5455	44	45843	45886	11291	11322	24	20
NC_005091.alt2	NC_010807.ref	69.7674	43	8007	8049	22537	22583	30	13
NC_005091.alt2	NC_010807.ref	69.7674	43	37114	37156	27217	27173	30	13
NC_005091.alt2	NC_010807.ref	69.0476	42	3379	3420	38241	38291	29	13
NC_005091.alt2	NC_010807.ref	65	40	5559	5598	15728	15671	26	14
NC_005091.alt2	NC_010807.ref	8e+01	40	50034	50073	5611	5580	32	8
NC_005091.alt2	NC_010807.ref	55.2632	38	48738	48775	36489	36461	21	17
NC_005091.alt2	NC_010807.ref	64.8649	37	19730	19766	25574	25503	24	13
NC_005091.alt2	NC_010807.ref	70.2703	37	54966	55002	32531	32567	26	11
NC_005091.alt2	NC_010807.ref	69.4444	36	13497	13532	10372	10435	25	11
NC_005091.alt2	NC_010807.ref	77.7778	36	31059	31094	21723	21668	28	8
NC_005091.alt2	NC_010807.ref	88.8889	36	61225	61260	2101	2070	32	4
NC_005091.alt2	NC_010807.ref	71.4286	35	11769	11803	36889	36958	25	10
NC_005091.alt2	NC_010807.ref	74.2857	35	60678	60712	16820	16869	26	9
NC_005091.alt2	NC_002486.alt	52	75	45094	45168	23808	23904	39	36
NC_005091.alt2	NC_002486.alt	5e+01	56	46259	46314	41696	41648	28	28
NC_005091.alt2	NC_002486.alt	52	50	13331	13380	26676	26599	26	24
NC_005091.alt2	NC_002486.alt	55.1020	49	32319	32367	19367	19407	27	22
NC_005091.alt2	NC_002486.alt	5e+01	48	7609	7656	11729	11798	24	24
NC_005091.alt2	NC_002486.alt	56.8182	44	28724	28767	21929	21893	25	19
NC_005091.alt2	NC_002486.alt	52.2727	44	62692	62735	34048	34017	23	21
NC_005091.alt2	NC_002486.alt	71.7949	39	51881	51919	42963	42894	28	11
NC_005091.alt2	NC_002486.alt	63.1579	38	54156	54193	20774	20813	24	14
NC_005091.alt2	NC_002486.alt	63.1579	38	54303	54340	20774	20813	24	14
NC_005091.alt2	NC_002486.alt	64.8649	37	48166	48202	19099	19138	24	13
NC_005091.alt2	NC_002486.alt	62.1622	37	61131	61167	10183	10154	23	14
NC_025457.alt2	NC_005091.ref	47.5728	103	20058	20160	47190	47044	49	54
NC_025457.alt2	NC_005091.ref	56.0606	66	2999	3064	55606	55653	37	29
NC_025457.alt2	NC_005091.ref	5e+01	60	36762	36821	22048	22120	30	30
NC_025457.alt2	NC_005091.ref	57.6271	59	60048	60106	20811	20863	34	25
NC_025457.alt2	NC_005091.ref	55.1724	58	8690	8747	9240	9157	32	26
NC_025457.alt2	NC_005091.ref	52.6316	57	26642	26698	6591	6521	30	27
NC_025457.alt2	NC_005091.ref	49.1228	57	39878	39934	4009	3960	28	29
NC_025457.alt2	NC_005091.ref	59.6491	57	60305	60361	46446	46510	34	23
NC_025457.alt2	NC_005091.ref	60.7143	56	6446	6501	20463	20554	34	22
NC_025457.alt2	NC_005091.ref	60.7143	56	6606	6661	20463	20554	34	22
NC_025457.alt2	NC_005091.ref	50.9434	53	47400	47452	30570	30648	27	26
NC_025457.alt2	NC_005091.ref	6e+01	50	32678	32727	49402	49337	30	20
NC_025457.alt2	NC_005091.ref	61.2245	49	53537	53585	16640	16716	30	19
NC_025457.alt2	NC_005091.ref	57.1429	49	59620	59668	55359	55274	28	21
NC_025457.alt2	NC_005091.ref	58.3333	48	20314	20361	49431	49388	28	20
NC_025457.alt2	NC_005091.ref	54.1667	48	51087	51134	15152	15114	26	22
NC_025457.alt2	NC_005091.ref	60.8696	46	14335	14380	53558	53611	28	18
NC_025457.alt2	NC_005091.ref	55.8140	43	38793	38835	1923	1882	24	19
NC_025457.alt2	NC_005091.ref	62.7907	43	42546	42588	3688	3737	27	16
NC_025457.alt2	NC_005091.ref	57.1429	42	17658	17699	30108	30078	24	18
NC_025457.alt2	NC_005091.ref	57.5	40	8609	8648	32059	32091	23	17
NC_025457.alt2	NC_005091.ref	6e+01	40	21173	21212	11787	11758	24	16
NC_025457.alt2	NC_005091.ref	65	40	45186	45225	25287	25248	26	14
NC_025457.alt2	NC_005091.ref	72.5	40	60567	60606	32449	32398	29	11
NC_025457.alt2	NC_005091.ref	57.5	40	62914	62953	19020	18992	23	17
NC_025457.alt2	NC_005091.ref	68.4211	38	15075	15112	29583	29529	26	12
NC_025457.alt2	NC_005091.ref	64.8649	37	27993	28029	45540	45504	24	13
NC_025457.alt2	NC_005091.ref	68.5714	35	31536	31570	40527	40561	24	11
NC_005091.alt2	NC_010807.alt3	51.8072	83	61107	61189	20989	21089	43	40
NC_005091.alt2	NC_010807.alt3	66.1972	71	31258	31328	33067	32964	47	24
NC_005091.alt2	NC_010807.alt3	55.2239	67	28485	28551	21257	21170	37	30
NC_005091.alt2	NC_010807.alt3	65.1515	66	21819	21884	19104	19194	43	23
NC_005091.alt2	NC_010807.alt3	65.1515	66	22017	22082	19104	19194	43	23
NC_005091.alt2	NC_010807.alt3	68.75	64	52647	52710	26636	26535	44	20
NC_005091.alt2	NC_010807.alt3	60.9375	64	62312	62375	2923	2999	39	25
NC_005091.alt2	NC_010807.alt3	61.9048	63	893	955	15516	15607	39	24
NC_005091.alt2	NC_010807.alt3	53.2258	62	46289	46350	26838	26903	33	29
NC_005091.alt2	NC_010807.alt3	54.0984	61	3124	3184	30759	30812	33	28
NC_005091.alt2	NC_010807.alt3	49.1525	59	12971	13029	17283	17210	29	30
NC_005091.alt2	NC_010807.alt3	50.8475	59	36409	36467	8172	8217	30	29
NC_005091.alt2	NC_010807.alt3	66.6667	57	36202	36258	21351	21278	38	19
NC_005091.alt2	NC_010807.alt3	58.9286	56	18839	18894	1202	1113	33	23
NC_005091.alt2	NC_010807.alt3	48.2143	56	59052	59107	33058	33132	27	29
NC_005091.alt2	NC_010807.alt3	50.9091	55	17454	17508	24690	24727	28	27
NC_005091.alt2	NC_010807.alt3	4e+01	55	27526	27580	25543	25497	22	33
NC_005091.alt2	NC_010807.alt3	50.9091	55	50569	50623	28314	28399	28	27
NC_005091.alt2	NC_010807.alt3	57.4074	54	23052	23105	22828	22746	31	23
NC_005091.alt2	NC_010807.alt3	54.7170	53	8353	8405	4144	4059	29	24
NC_005091.alt2	NC_010807.alt3	66.0377	53	26112	26164	24124	24068	35	18
NC_005091.alt2	NC_010807.alt3	61.5385	52	3641	3692	30200	30125	32	20
NC_005091.alt2	NC_010807.alt3	55.7692	52	4854	4905	10265	10221	29	23
NC_005091.alt2	NC_010807.alt3	5e+01	52	45473	45524	29379	29336	26	26
NC_005091.alt2	NC_010807.alt3	58.8235	51	49227	49277	2816	2742	30	21
NC_005091.alt2	NC_010807.alt3	64	50	25830	25879	23711	23783	32	18
NC_005091.alt2	NC_010807.alt3	61.2245	49	47281	47329	15929	15882	30	19
NC_005091.alt2	NC_010807.alt3	53.0612	49	57149	57197	20995	20962	26	23
NC_005091.alt2	NC_010807.alt3	55.1020	49	60773	60821	7135	7062	27	22
NC_005091.alt2	NC_010807.alt3	51.1111	45	1638	1682	30732	30777	23	22
NC_005091.alt2	NC_010807.alt3	66.6667	45	57993	58037	35304	35234	30	15
NC_005091.alt2	NC_010807.alt3	54.5455	44	45843	45886	11507	11538	24	20
NC_005091.alt2	NC_010807.alt3	69.7674	43	37114	37156	27356	27312	30	13
NC_005091.alt2	NC_010807.alt3	69.0476	42	3379	3420	39317	39367	29	13
NC_005091.alt2	NC_010807.alt3	65	40	5559	5598	15981	15924	26	14
NC_005091.alt2	NC_010807.alt3	8e+01	40	50034	50073	6048	6017	32	8
NC_005091.alt2	NC_010807.alt3	61.5385	39	20750	20788	1249	1200	24	15
NC_005091.alt2	NC_010807.alt3	58.9744	39	43565	43603	34831	34786	23	16
NC_005091.alt2	NC_010807.alt3	55.2632	38	48738	48775	37497	37469	21	17
NC_005091.alt2	NC_010807.alt3	64.8649	37	19730	19766	25920	25849	24	13
NC_005091.alt2	NC_010807.alt3	70.2703	37	54966	55002	32783	32819	26	11
NC_005091.alt2	NC_010807.alt3	69.4444	36	13497	13532	10588	10651	25	11
NC_005091.alt2	NC_010807.alt3	88.8889	36	61225	61260	2519	2488	32	4
NC_005091.alt2	NC_010807.alt3	71.4286	35	11769	11803	38240	38309	25	10
NC_005091.alt2	NC_010807.alt3	74.2857	35	60678	60712	17073	17122	26	9
NC_025457.alt2	NC_005091.alt1	48.5437	103	20058	20160	47352	47206	50	53
NC_025457.alt2	NC_005091.alt1	56.0606	66	2999	3064	55606	55653	37	29
NC_025457.alt2	NC_005091.alt1	5e+01	66	27138	27203	28859	28934	33	33
NC_025457.alt2	NC_005091.alt1	44.2623	61	30596	30656	49692	49641	27	34
NC_025457.alt2	NC_005091.alt1	5e+01	60	36762	36821	22048	22120	30	30
NC_025457.alt2	NC_005091.alt1	54.2373	59	34249	34307	11009	11104	32	27
NC_025457.alt2	NC_005091.alt1	56.8966	58	8690	8747	9240	9157	33	25
NC_025457.alt2	NC_005091.alt1	51.7241	58	45133	45190	52495	52564	30	28
NC_025457.alt2	NC_005091.alt1	41.0714	56	62502	62557	45950	45998	23	33
NC_025457.alt2	NC_005091.alt1	55.5556	54	29057	29110	29145	29193	30	24
NC_025457.alt2	NC_005091.alt1	55.7692	52	6738	6789	35201	35164	29	23
NC_025457.alt2	NC_005091.alt1	57.1429	49	59620	59668	55359	55274	28	21
NC_025457.alt2	NC_005091.alt1	56.25	48	20314	20361	49680	49637	27	21
NC_025457.alt2	NC_005091.alt1	58.3333	48	39988	40035	12462	12508	28	20
NC_025457.alt2	NC_005091.alt1	59.5745	47	8325	8371	41820	41762	28	19
NC_025457.alt2	NC_005091.alt1	61.7021	47	60873	60919	47076	47129	29	18
NC_025457.alt2	NC_005091.alt1	63.0435	46	14335	14380	53807	53860	29	17
NC_025457.alt2	NC_005091.alt1	54.3478	46	28424	28469	39765	39825	25	21
NC_025457.alt2	NC_005091.alt1	6e+01	45	17658	17702	30021	29958	27	18
NC_025457.alt2	NC_005091.alt1	55.8140	43	38793	38835	1830	1871	24	19
NC_025457.alt2	NC_005091.alt1	60.4651	43	42546	42588	3688	3737	26	17
NC_025457.alt2	NC_005091.alt1	5e+01	42	26308	26349	12899	12933	21	21
NC_025457.alt2	NC_005091.alt1	59.5238	42	27726	27767	18279	18326	25	17
NC_025457.alt2	NC_005091.alt1	57.5	40	8609	8648	32116	32148	23	17
NC_025457.alt2	NC_005091.alt1	6e+01	40	21173	21212	11787	11758	24	16
NC_025457.alt2	NC_005091.alt1	65	40	26587	26626	31944	31908	26	14
NC_025457.alt2	NC_005091.alt1	72.5	40	60567	60606	32658	32709	29	11
NC_025457.alt2	NC_005091.alt1	67.5	40	62384	62423	7238	7194	27	13
NC_025457.alt2	NC_005091.alt1	55	40	62914	62953	19020	18991	22	18
NC_025457.alt2	NC_005091.alt1	64.1026	39	40615	40653	43478	43421	25	14
NC_025457.alt2	NC_005091.alt1	71.4286	35	11226	11260	8295	8234	25	10
NC_025457.alt2	NC_005091.alt1	74.2857	35	25353	25387	46605	46675	26	9
NC_025457.alt2	NC_005091.alt2	47.7273	88	15615	15702	17711	17822	42	46
NC_025457.alt2	NC_005091.alt2	46.5753	73	61445	61517	24813	24751	34	39
NC_025457.alt2	NC_005091.alt2	45.3125	64	25140	25203	8098	8045	29	35
NC_025457.alt2	NC_005091.alt2	55.1724	58	8690	8747	10110	10027	32	26
NC_025457.alt2	NC_005091.alt2	5e+01	56	39234	39289	13650	13705	28	28
NC_025457.alt2	NC_005091.alt2	55.5556	54	62232	62285	20780	20722	30	24
NC_025457.alt2	NC_005091.alt2	59.6154	52	27955	28006	43041	42977	31	21
NC_025457.alt2	NC_005091.alt2	6e+01	50	32678	32727	54321	54256	30	20
NC_025457.alt2	NC_005091.alt2	59.1837	49	59620	59668	61462	61377	29	20
NC_025457.alt2	NC_005091.alt2	58.3333	48	20314	20361	54350	54307	28	20
NC_025457.alt2	NC_005091.alt2	58.3333	48	42023	42070	63401	63357	28	20
NC_025457.alt2	NC_005091.alt2	53.1915	47	51087	51133	16509	16471	25	22
NC_025457.alt2	NC_005091.alt2	66.6667	45	43852	43896	9785	9839	30	15
NC_025457.alt2	NC_005091.alt2	6e+01	45	60661	60705	56368	56329	27	18
NC_025457.alt2	NC_005091.alt2	58.1395	43	12662	12704	16546	16488	25	18
NC_025457.alt2	NC_005091.alt2	66.6667	42	17078	17119	3562	3613	28	14
NC_025457.alt2	NC_005091.alt2	57.1429	42	17658	17699	33279	33249	24	18
NC_025457.alt2	NC_005091.alt2	57.5	40	8609	8648	35623	35655	23	17
NC_025457.alt2	NC_005091.alt2	57.5	40	62914	62953	20978	20950	23	17
NC_025457.alt2	NC_005091.alt2	64.1026	39	1569	1607	56060	56112	25	14
NC_025457.alt2	NC_005091.alt2	55.2632	38	11225	11262	28367	28336	21	17
NC_025457.alt2	NC_005091.alt2	68.4211	38	15075	15112	32754	32700	26	12
NC_025457.alt2	NC_005091.alt2	68.4211	38	37720	37757	3765	3826	26	12
NC_025457.alt2	NC_005091.alt2	57.8947	38	49318	49355	1270	1298	22	16
NC_025457.alt2	NC_005091.alt2	71.0526	38	61970	62007	2335	2304	27	11
NC_025457.alt2	NC_005091.alt2	69.4444	36	31417	31452	5188	5229	25	11
NC_025457.alt2	NC_005091.alt2	68.5714	35	57329	57363	27070	27118	24	11
NC_005091.alt2	NC_025457.alt2	55.5556	72	36869	36940	26975	27082	40	32
NC_005091.alt2	NC_025457.alt2	41.4286	70	50208	50277	11993	11933	29	41
NC_005091.alt2	NC_025457.alt2	55.8824	68	42918	42985	34945	35001	38	30
NC_005091.alt2	NC_025457.alt2	55.3846	65	33195	33259	60767	60697	36	29
NC_005091.alt2	NC_025457.alt2	52.3810	63	9103	9165	16636	16581	33	30
NC_005091.alt2	NC_025457.alt2	52.4590	61	54541	54601	33074	33162	32	29
NC_005091.alt2	NC_025457.alt2	59.3220	59	31001	31059	50673	50596	35	24
NC_005091.alt2	NC_025457.alt2	51.7241	58	13679	13736	21647	21600	30	28
NC_005091.alt2	NC_025457.alt2	63.7931	58	14159	14216	1821	1742	37	21
NC_005091.alt2	NC_025457.alt2	58.6207	58	17397	17454	22064	22013	34	24
NC_005091.alt2	NC_025457.alt2	49.1228	57	16691	16747	37726	37772	28	29
NC_005091.alt2	NC_025457.alt2	56.1404	57	55747	55803	49121	49195	32	25
NC_005091.alt2	NC_025457.alt2	55.3571	56	48627	48682	3595	3515	31	25
NC_005091.alt2	NC_025457.alt2	46.4286	56	62170	62225	42983	42935	26	30
NC_005091.alt2	NC_025457.alt2	57.6923	52	3562	3613	17078	17121	30	22
NC_005091.alt2	NC_025457.alt2	55.7692	52	22261	22312	11658	11713	29	23
NC_005091.alt2	NC_025457.alt2	64	50	19941	19990	27724	27767	32	18
NC_005091.alt2	NC_025457.alt2	62	50	23286	23335	60048	60127	31	19
NC_005091.alt2	NC_025457.alt2	55.1020	49	27070	27118	57329	57369	27	22
NC_005091.alt2	NC_025457.alt2	54.1667	48	20197	20244	4204	4281	26	22
NC_005091.alt2	NC_025457.alt2	54.1667	48	20394	20441	4204	4281	26	22
NC_005091.alt2	NC_025457.alt2	48.9362	47	36003	36049	60577	60540	23	24
NC_005091.alt2	NC_025457.alt2	63.8298	47	38695	38741	6864	6944	30	17
NC_005091.alt2	NC_025457.alt2	59.0909	44	57925	57968	49746	49666	26	18
NC_005091.alt2	NC_025457.alt2	59.5238	42	5188	5229	31417	31452	25	17
NC_005091.alt2	NC_025457.alt2	60.9756	41	3849	3889	47248	47217	25	16
NC_005091.alt2	NC_025457.alt2	65.8537	41	52124	52164	32256	32308	27	14
NC_005091.alt2	NC_025457.alt2	6e+01	40	22909	22948	29684	29714	24	16
NC_005091.alt2	NC_025457.alt2	66.6667	39	28007	28045	45224	45186	26	13
NC_005091.alt2	NC_025457.alt2	73.6842	38	46455	46492	53747	53698	28	10
NC_005091.alt2	NC_025457.alt2	68.4211	38	60935	60972	51635	51704	26	12
NC_005091.alt2	NC_025457.alt2	64.8649	37	49747	49783	28029	27993	24	13
NC_005091.alt2	NC_025457.alt2	64.8649	37	49937	49973	28029	27993	24	13
NC_005091.alt2	NC_025457.alt2	65.7143	35	8266	8300	46656	46601	23	12
NC_005091.alt2	NC_025457.alt2	71.4286	35	38516	38550	6864	6932	25	10
NC_005091.alt2	NC_005091.ref	95.9980	4073	5947	10019	5269	9341	3910	163
NC_005091.alt2	NC_005091.ref	96.25	3520	15610	19129	14253	17772	3388	132
NC_005091.alt2	NC_005091.ref	96.0868	3271	44584	47854	40544	43814	3143	128
NC_005091.alt2	NC_005091.ref	96.5744	2277	51479	53755	46841	49117	2199	78
NC_005091.alt2	NC_005091.ref	96.0258	2013	35479	37491	31915	33927	1933	80
NC_005091.alt2	NC_005091.ref	96.0396	1919	12061	13979	10933	12851	1843	76
NC_005091.alt2	NC_005091.ref	96.7725	1890	596	2485	474	2363	1829	61
NC_005091.alt2	NC_005091.ref	96.3558	1866	56469	58334	51258	53123	1798	68
NC_005091.alt2	NC_005091.ref	96.6648	1799	40172	41970	36008	37806	1739	60
NC_005091.alt2	NC_005091.ref	95.6912	1671	62026	63696	55785	57455	1599	72
NC_005091.alt2	NC_005091.ref	96.6625	1618	60408	62025	54305	55922	1564	54
NC_005091.alt2	NC_005091.ref	96.9298	1596	47982	49577	43821	45416	1547	49
NC_005091.alt2	NC_005091.ref	95.7679	1465	25123	26587	22714	24178	1403	62
NC_005091.alt2	NC_005091.ref	96.5092	1461	30847	32307	27983	29443	1410	51
NC_005091.alt2	NC_005091.ref	96.5541	1451	54252	55702	49333	50783	1401	50
NC_005091.alt2	NC_005091.ref	95.7706	1395	3240	4634	2839	4233	1336	59
NC_005091.alt2	NC_005091.ref	97.0951	1377	10684	12060	9661	11037	1337	40
NC_005091.alt2	NC_005091.ref	96.3498	1315	43269	44583	39140	40454	1267	48
NC_005091.alt2	NC_005091.ref	96.9975	1199	49871	51069	45438	46636	1163	36
NC_005091.alt2	NC_005091.ref	96.2037	1080	22462	23541	19987	21066	1039	41
NC_005091.alt2	NC_005091.ref	96.2547	1068	28400	29467	26025	27092	1028	40
NC_005091.alt2	NC_005091.ref	97.7	1000	29847	30846	27129	28128	977	23
NC_005091.alt2	NC_005091.ref	95.5897	975	33690	34664	30374	31348	932	43
NC_005091.alt2	NC_005091.ref	96.2963	918	32627	33544	29456	30373	884	34
NC_005091.alt2	NC_005091.ref	97.3626	910	14700	15609	13510	14419	886	24
NC_005091.alt2	NC_005091.ref	97.1564	844	19450	20293	17786	18629	820	24
NC_005091.alt2	NC_005091.ref	95.5990	818	23542	24359	21248	22065	782	36
NC_005091.alt2	NC_005091.ref	97.7887	814	34665	35478	31245	32058	796	18
NC_005091.alt2	NC_005091.ref	98.5469	757	26588	27344	23982	24738	746	11
NC_005091.alt2	NC_005091.ref	97.0822	754	27345	28098	24587	25340	732	22
NC_005091.alt2	NC_005091.ref	98.9505	667	58837	59503	53248	53914	660	7
NC_005091.alt2	NC_005091.ref	97.2892	664	10020	10683	9150	9813	646	18
NC_005091.alt2	NC_005091.ref	97.5385	650	20294	20943	18433	19082	634	16
NC_005091.alt2	NC_005091.ref	97.7883	633	20944	21576	18986	19618	619	14
NC_005091.alt2	NC_005091.ref	97.6303	633	39539	40171	35499	36131	618	15
NC_005091.alt2	NC_005091.ref	97.4790	595	1	595	1	595	580	15
NC_005091.alt2	NC_005091.ref	96.1345	595	38943	39537	34719	35313	572	23
NC_005091.alt2	NC_005091.ref	95.7411	587	55882	56468	50779	51365	562	25
NC_005091.alt2	NC_005091.ref	94.7461	571	2486	3056	2279	2849	541	30
NC_005091.alt2	NC_005091.ref	96.1131	566	4635	5200	4103	4668	544	22
NC_005091.alt2	NC_005091.ref	98.8615	527	59881	60407	53952	54478	521	6
NC_005091.alt2	NC_005091.ref	99.3952	496	53756	54251	48984	49479	493	3
NC_005091.alt2	NC_005091.ref	97.3577	492	13980	14471	12771	13262	479	13
NC_005091.alt2	NC_005091.ref	98.9796	490	21972	22461	19622	20111	485	5
NC_005091.alt2	NC_005091.ref	98.9733	487	38075	38561	34153	34639	482	5
NC_005091.alt2	NC_005091.ref	97.1302	453	42816	43268	38468	38920	440	13
NC_005091.alt2	NC_005091.ref	98.0488	410	41971	42380	37664	38073	402	8
NC_005091.alt2	NC_005091.ref	98.0440	409	51070	51478	46512	46920	401	8
NC_005091.alt2	NC_005091.ref	1e+02	395	21577	21971	19425	19819	395	0
NC_005091.alt2	NC_005091.ref	98.7277	393	5554	5946	4977	5369	388	5
NC_005091.alt2	NC_005091.ref	98.4252	381	38562	38942	34461	34841	375	6
NC_005091.alt2	NC_005091.ref	1e+02	379	29468	29846	26938	27316	379	0
NC_005091.alt2	NC_005091.ref	99.4695	377	59504	59880	53742	54118	375	2
NC_005091.alt2	NC_005091.ref	98.125	320	19130	19449	17582	17901	314	6
NC_005091.alt2	NC_005091.ref	97.1429	315	24360	24674	21951	22265	306	9
NC_005091.alt2	NC_005091.ref	98.3766	308	37767	38074	33933	34240	303	5
NC_005091.alt2	NC_005091.ref	95.3488	301	28099	28399	25462	25762	287	14
NC_005091.alt2	NC_005091.ref	1e+02	293	49578	49870	45335	45627	293	0
NC_005091.alt2	NC_005091.ref	95.1724	290	24833	25122	22269	22558	276	14
NC_005091.alt2	NC_005091.ref	95.2381	273	58564	58836	53134	53406	260	13
NC_005091.alt2	NC_005091.ref	98.5240	271	42545	42815	38343	38613	267	4
NC_005091.alt2	NC_005091.ref	1e+02	262	5201	5462	26024	25763	262	0
NC_005091.alt2	NC_005091.ref	98.2533	229	58335	58563	38921	39149	225	4
NC_005091.alt2	NC_005091.ref	96.4912	228	14472	14699	13137	13364	220	8
NC_005091.alt2	NC_005091.ref	1e+02	217	32308	32524	4975	4759	217	0
NC_005091.alt2	NC_005091.ref	1e+02	183	3057	3239	38085	38267	183	0
NC_005091.alt2	NC_005091.ref	1e+02	181	37494	37674	21245	21065	181	0
NC_005091.alt2	NC_005091.ref	1e+02	179	55703	55881	35322	35500	179	0
NC_005091.alt2	NC_005091.ref	1e+02	155	24678	24832	22557	22711	155	0
NC_005091.alt2	NC_005091.ref	1e+02	145	33545	33689	13509	13365	145	0
NC_005091.alt2	NC_005091.ref	98.4252	127	47855	47981	25341	25467	125	2
NC_005091.alt2	NC_005091.ref	1e+02	102	32525	32626	29444	29545	102	0
NC_005091.alt2	NC_005091.ref	1e+02	92	37675	37766	33930	34021	92	0
NC_005091.alt2	NC_005091.ref	95.6044	91	5463	5553	4669	4759	87	4
NC_005091.alt2	NC_005091.ref	1e+02	91	42454	42544	40543	40453	91	0
NC_005091.alt2	NC_005091.ref	92.8571	70	42384	42453	38271	38340	65	5
NC_005091.alt1	NC_025457.ref	55.8140	86	49791	49876	39041	38932	48	38
NC_005091.alt1	NC_025457.ref	59.7403	77	32658	32734	40556	40650	46	31
NC_005091.alt1	NC_025457.ref	5e+01	74	29685	29758	1797	1903	37	37
NC_005091.alt1	NC_025457.ref	40.5797	69	47951	48019	359	418	28	41
NC_005091.alt1	NC_025457.ref	57.8125	64	7988	8051	25032	25112	37	27
NC_005091.alt1	NC_025457.ref	38.0952	63	2054	2116	8964	9019	24	39
NC_005091.alt1	NC_025457.ref	48.3333	60	18939	18998	33405	33313	29	31
NC_005091.alt1	NC_025457.ref	56.1404	57	16895	16951	19348	19276	32	25
NC_005091.alt1	NC_025457.ref	54.3860	57	45534	45590	30075	30120	31	26
NC_005091.alt1	NC_025457.ref	40.3509	57	46795	46851	13269	13318	23	34
NC_005091.alt1	NC_025457.ref	54.9020	51	5129	5179	14906	14957	28	23
NC_005091.alt1	NC_025457.ref	52	50	55046	55095	19324	19366	26	24
NC_005091.alt1	NC_025457.ref	53.0612	49	14543	14591	35514	35475	26	23
NC_005091.alt1	NC_025457.ref	57.1429	49	30466	30514	21846	21879	28	21
NC_005091.alt1	NC_025457.ref	64.5833	48	18279	18326	17949	17990	31	17
NC_005091.alt1	NC_025457.ref	55.3191	47	9456	9502	32822	32782	26	21
NC_005091.alt1	NC_025457.ref	59.5745	47	29915	29961	13900	13949	28	19
NC_005091.alt1	NC_025457.ref	59.5745	47	29982	30028	27115	27075	28	19
NC_005091.alt1	NC_025457.ref	72.3404	47	45008	45054	6499	6568	34	13
NC_005091.alt1	NC_025457.ref	66.6667	45	42927	42971	41196	41237	30	15
NC_005091.alt1	NC_025457.ref	5e+01	42	26216	26257	22821	22855	21	21
NC_005091.alt1	NC_025457.ref	60.9756	41	809	849	40900	40854	25	16
NC_005091.alt1	NC_025457.ref	56.4103	39	15315	15353	3749	3776	22	17
NC_005091.alt2	NC_005091.alt1	92.6348	2634	15610	18243	14253	16886	2440	194
NC_005091.alt2	NC_005091.alt1	92.9306	2334	45521	47854	41787	44120	2169	165
NC_005091.alt2	NC_005091.alt1	92.8605	2115	51479	53593	47003	49117	1964	151
NC_005091.alt2	NC_005091.alt1	93.3810	2100	5998	8097	5320	7419	1961	139
NC_005091.alt2	NC_005091.alt1	93.9979	1866	56469	58334	51507	53372	1754	112
NC_005091.alt2	NC_005091.alt1	93.6076	1799	40172	41970	36314	38112	1684	115
NC_005091.alt2	NC_005091.alt1	93.8195	1618	60408	62025	54305	55922	1518	100
NC_005091.alt2	NC_005091.alt1	93.4842	1458	30850	32307	27899	29356	1363	95
NC_005091.alt2	NC_005091.alt1	92.5824	1456	12524	13979	11396	12851	1348	108
NC_005091.alt2	NC_005091.alt1	93.8493	1447	54252	55698	49582	51028	1358	89
NC_005091.alt2	NC_005091.alt1	93.5361	1315	43269	44583	39446	40760	1230	85
NC_005091.alt2	NC_005091.alt1	93.3689	1312	622	1933	500	1811	1225	87
NC_005091.alt2	NC_005091.alt1	92.7075	1289	25123	26411	22714	24002	1195	94
NC_005091.alt2	NC_005091.alt1	92.9796	1225	36019	37243	32761	33985	1139	86
NC_005091.alt2	NC_005091.alt1	94.0692	1214	8806	10019	8128	9341	1142	72
NC_005091.alt2	NC_005091.alt1	93.2115	1149	62031	63179	55790	56938	1071	78
NC_005091.alt2	NC_005091.alt1	92.8320	851	44584	45434	40850	41700	790	61
NC_005091.alt2	NC_005091.alt1	94.4247	843	19450	20292	17786	18628	796	47
NC_005091.alt2	NC_005091.alt1	91.8689	824	3602	4425	3201	4024	757	67
NC_005091.alt2	NC_005091.alt1	94.9631	814	34665	35478	31302	32115	773	41
NC_005091.alt2	NC_005091.alt1	92.2876	765	32627	33391	29369	30133	706	59
NC_005091.alt2	NC_005091.alt1	95.1252	759	18371	19129	17014	17772	722	37
NC_005091.alt2	NC_005091.alt1	94.9602	754	27345	28098	24587	25340	716	38
NC_005091.alt2	NC_005091.alt1	94.1255	749	49871	50619	45600	46348	705	44
NC_005091.alt2	NC_005091.alt1	93.3884	726	22816	23541	20341	21066	678	48
NC_005091.alt2	NC_005091.alt1	94.3370	724	28741	29464	26279	27002	683	41
NC_005091.alt2	NC_005091.alt1	93.5766	685	10687	11371	9664	10348	641	44
NC_005091.alt2	NC_005091.alt1	92.9927	685	23675	24359	21381	22065	637	48
NC_005091.alt2	NC_005091.alt1	96.8516	667	58837	59503	53497	54163	646	21
NC_005091.alt2	NC_005091.alt1	93.9759	664	10020	10683	9150	9813	624	40
NC_005091.alt2	NC_005091.alt1	94.1538	650	20294	20943	18433	19082	612	38
NC_005091.alt2	NC_005091.alt1	95.5766	633	39539	40171	35805	36437	605	28
NC_005091.alt2	NC_005091.alt1	92.5676	592	48625	49216	44626	45217	548	44
NC_005091.alt2	NC_005091.alt1	92.9795	584	55885	56468	51031	51614	543	41
NC_005091.alt2	NC_005091.alt1	94.1799	567	30280	30846	27475	28041	534	33
NC_005091.alt2	NC_005091.alt1	96.4539	564	11497	12060	10474	11037	544	20
NC_005091.alt2	NC_005091.alt1	91.6221	561	2486	3046	2279	2839	514	47
NC_005091.alt2	NC_005091.alt1	92.8571	518	4683	5200	4151	4668	481	37
NC_005091.alt2	NC_005091.alt1	93.6047	516	14700	15215	13510	14025	483	33
NC_005091.alt2	NC_005091.alt1	93.1864	499	47982	48480	44127	44625	465	34
NC_005091.alt2	NC_005091.alt1	92.1371	496	8186	8681	7508	8003	457	39
NC_005091.alt2	NC_005091.alt1	96.3710	496	53756	54251	49233	49728	478	18
NC_005091.alt2	NC_005091.alt1	93.9024	492	13980	14471	12771	13262	462	30
NC_005091.alt2	NC_005091.alt1	94.2605	453	42816	43268	38774	39226	427	26
NC_005091.alt2	NC_005091.alt1	96.0976	410	41971	42380	37970	38379	394	16
NC_005091.alt2	NC_005091.alt1	96.3325	409	51070	51478	46674	47082	394	15
NC_005091.alt2	NC_005091.alt1	93.8272	405	3	407	3	407	380	25
NC_005091.alt2	NC_005091.alt1	95.8333	384	26961	27344	24355	24738	368	16
NC_005091.alt2	NC_005091.alt1	95.3003	383	35479	35861	31972	32354	365	18
NC_005091.alt2	NC_005091.alt1	98.1530	379	29468	29846	26851	27229	372	7
NC_005091.alt2	NC_005091.alt1	94.6927	358	12061	12418	10933	11290	339	19
NC_005091.alt2	NC_005091.alt1	92.4370	357	38943	39299	35025	35381	330	27
NC_005091.alt2	NC_005091.alt1	96.0452	354	38075	38428	34459	34812	340	14
NC_005091.alt2	NC_005091.alt1	93.4659	352	50718	51069	46447	46798	329	23
NC_005091.alt2	NC_005091.alt1	94.8571	350	29847	30196	27042	27391	332	18
NC_005091.alt2	NC_005091.alt1	95.625	320	19130	19449	17582	17901	306	14
NC_005091.alt2	NC_005091.alt1	93.6508	315	24360	24674	21951	22265	295	20
NC_005091.alt2	NC_005091.alt1	95.4545	308	37767	38074	34239	34546	294	14
NC_005091.alt2	NC_005091.alt1	97.3770	305	21580	21884	19428	19732	297	8
NC_005091.alt2	NC_005091.alt1	94.0789	304	34361	34664	31102	31405	286	18
NC_005091.alt2	NC_005091.alt1	92.3588	301	28099	28399	25462	25762	278	23
NC_005091.alt2	NC_005091.alt1	96.6443	298	15312	15609	14122	14419	288	10
NC_005091.alt2	NC_005091.alt1	96.3087	298	59504	59801	53991	54288	287	11
NC_005091.alt2	NC_005091.alt1	97.6109	293	49578	49870	45497	45789	286	7
NC_005091.alt2	NC_005091.alt1	92.0690	290	24833	25122	22269	22558	267	23
NC_005091.alt2	NC_005091.alt1	93.6170	282	33839	34120	30580	30861	264	18
NC_005091.alt2	NC_005091.alt1	94.9458	277	5670	5946	5093	5369	263	14
NC_005091.alt2	NC_005091.alt1	93.8628	277	20944	21220	18986	19262	260	17
NC_005091.alt2	NC_005091.alt1	93.4066	273	58564	58836	53383	53655	255	18
NC_005091.alt2	NC_005091.alt1	95.9410	271	42545	42815	38649	38919	260	11
NC_005091.alt2	NC_005091.alt1	94.4238	269	49309	49577	45310	45578	254	15
NC_005091.alt2	NC_005091.alt1	97.7099	262	5201	5462	26024	25763	256	6
NC_005091.alt2	NC_005091.alt1	94.1406	256	3240	3495	2839	3094	241	15
NC_005091.alt2	NC_005091.alt1	94.4664	253	28400	28652	26025	26277	239	14
NC_005091.alt2	NC_005091.alt1	94.4664	253	38690	38942	34895	35147	239	14
NC_005091.alt2	NC_005091.alt1	97.5904	249	59969	60217	32355	32603	243	6
NC_005091.alt2	NC_005091.alt1	97.1545	246	22216	22461	19866	20111	239	7
NC_005091.alt2	NC_005091.alt1	95.2991	234	21343	21576	19385	19618	223	11
NC_005091.alt2	NC_005091.alt1	96.9432	229	58335	58563	39227	39455	222	7
NC_005091.alt2	NC_005091.alt1	90.7895	228	14472	14699	13137	13364	207	21
NC_005091.alt2	NC_005091.alt1	94.5946	222	22462	22683	19987	20208	210	12
NC_005091.alt2	NC_005091.alt1	94.4700	217	63273	63489	57032	57248	205	12
NC_005091.alt2	NC_005091.alt1	96.0591	203	32322	32524	4961	4759	195	8
NC_005091.alt2	NC_005091.alt1	97.4093	193	3047	3239	38381	38573	188	5
NC_005091.alt2	NC_005091.alt1	95.7895	190	60218	60407	54289	54478	182	8
NC_005091.alt2	NC_005091.alt1	98.3607	183	55699	55881	35624	35806	180	3
NC_005091.alt2	NC_005091.alt1	94.4751	181	37494	37674	21245	21065	171	10
NC_005091.alt2	NC_005091.alt1	94.9045	157	53599	53755	49210	49366	149	8
NC_005091.alt2	NC_005091.alt1	98.0645	155	24678	24832	22557	22711	152	3
NC_005091.alt2	NC_005091.alt1	94.0789	152	2066	2217	1944	2095	143	9
NC_005091.alt2	NC_005091.alt1	96.6443	149	33392	33540	30280	30132	144	5
NC_005091.alt2	NC_005091.alt1	93.8776	147	37345	37491	34087	34233	138	9
NC_005091.alt2	NC_005091.alt1	98.6301	146	33544	33689	13510	13365	144	2
NC_005091.alt2	NC_005091.alt1	97.2222	144	48481	48624	30434	30577	140	4
NC_005091.alt2	NC_005091.alt1	97.0803	137	2223	2359	2237	2101	133	4
NC_005091.alt2	NC_005091.alt1	95.5556	135	39403	39537	35485	35619	129	6
NC_005091.alt2	NC_005091.alt1	97.7444	133	22083	22215	19864	19732	130	3
NC_005091.alt2	NC_005091.alt1	97.7273	132	1934	2065	1941	1810	129	3
NC_005091.alt2	NC_005091.alt1	93.9394	132	22684	22815	20340	20209	124	8
NC_005091.alt2	NC_005091.alt1	92.4242	132	33701	33832	30429	30298	122	10
NC_005091.alt2	NC_005091.alt1	97.6563	128	26718	26845	24112	24239	125	3
NC_005091.alt2	NC_005091.alt1	94.4882	127	47855	47981	25341	25467	120	7
NC_005091.alt2	NC_005091.alt1	92.8571	126	2360	2485	2238	2363	117	9
NC_005091.alt2	NC_005091.alt1	86.2903	124	4428	4551	4124	3967	107	17
NC_005091.alt2	NC_005091.alt1	96.7213	122	21221	21342	19382	19261	118	4
NC_005091.alt2	NC_005091.alt1	95.0413	121	8685	8805	8127	8007	115	6
NC_005091.alt2	NC_005091.alt1	99.1736	121	18247	18367	17010	16890	120	1
NC_005091.alt2	NC_005091.alt1	95.8333	120	11374	11493	10467	10348	115	5
NC_005091.alt2	NC_005091.alt1	96.5812	117	23555	23671	21377	21261	113	4
NC_005091.alt2	NC_005091.alt1	99.1379	116	5554	5669	5077	4962	115	1
NC_005091.alt2	NC_005091.alt1	93.9655	116	34121	34236	30974	30859	109	7
NC_005091.alt2	NC_005091.alt1	93.0435	115	26846	26960	24344	24230	107	8
NC_005091.alt2	NC_005091.alt1	91.9643	112	63490	63601	57359	57248	103	9
NC_005091.alt2	NC_005091.alt1	98.1982	111	21972	22082	19622	19732	109	2
NC_005091.alt2	NC_005091.alt1	1e+02	109	26412	26520	24104	23996	109	0
NC_005091.alt2	NC_005091.alt1	94.3396	106	3496	3601	3189	3084	100	6
NC_005091.alt2	NC_005091.alt1	92.3810	105	12419	12523	11394	11290	97	8
NC_005091.alt2	NC_005091.alt1	96.1538	104	35913	36016	32758	32655	100	4
NC_005091.alt2	NC_005091.alt1	97.0588	102	32525	32626	29357	29458	99	3
NC_005091.alt2	NC_005091.alt1	96.0784	102	39301	39402	35483	35382	98	4
NC_005091.alt2	NC_005091.alt1	94.0594	101	37244	37344	34086	33986	95	6
NC_005091.alt2	NC_005091.alt1	94.8454	97	50620	50716	46443	46347	92	5
NC_005091.alt2	NC_005091.alt1	95.8333	96	15216	15311	14118	14023	92	4
NC_005091.alt2	NC_005091.alt1	94.6809	94	408	501	499	406	89	5
NC_005091.alt2	NC_005091.alt1	95.7447	94	502	595	502	595	90	4
NC_005091.alt2	NC_005091.alt1	95.6522	92	34269	34360	31100	31009	88	4
NC_005091.alt2	NC_005091.alt1	97.8261	92	49217	49308	45308	45217	90	2
NC_005091.alt2	NC_005091.alt1	93.4783	92	63605	63696	57364	57455	86	6
NC_005091.alt2	NC_005091.alt1	95.6044	91	37676	37766	34237	34327	87	4
NC_005091.alt2	NC_005091.alt1	93.3333	90	63183	63272	57028	56939	84	6
NC_005091.alt2	NC_005091.alt1	93.2584	89	5465	5553	4671	4759	83	6
NC_005091.alt2	NC_005091.alt1	97.7528	89	42456	42544	40847	40759	87	2
NC_005091.alt2	NC_005091.alt1	93.1818	88	8098	8185	7499	7412	82	6
NC_005091.alt2	NC_005091.alt1	93.1818	88	28653	28740	49209	49122	82	6
NC_005091.alt2	NC_005091.alt1	94.3182	88	59881	59968	54201	54288	83	5
NC_005091.alt2	NC_005091.alt1	1e+02	87	21885	21971	19864	19778	87	0
NC_005091.alt2	NC_005091.alt1	90.5882	85	26588	26672	23742	23826	77	8
NC_005091.alt2	NC_005091.alt1	97.6471	85	45436	45520	41785	41701	83	2
NC_005091.alt2	NC_005091.alt1	96.3855	83	4552	4634	4151	4233	80	3
NC_005091.alt2	NC_005091.alt1	92.7711	83	30197	30279	27465	27383	77	6
NC_005091.alt2	NC_005091.alt1	1e+02	82	38429	38510	34892	34811	82	0
NC_005091.alt2	NC_005091.alt1	1e+02	82	38608	38689	34892	34811	82	0
NC_005091.alt2	NC_005091.alt1	1e+02	79	59802	59880	32355	32433	79	0
NC_005091.alt2	NC_005091.alt1	91.4286	70	42384	42453	38577	38646	64	6
NC_005091.alt2	NC_005091.alt1	98.5075	67	26521	26587	24112	24178	66	1
NC_005091.alt2	NC_005091.alt1	88.2353	51	35862	35912	32604	32654	45	6
NC_005091.alt2	NC_005091.alt1	94.1176	51	38511	38561	34895	34945	48	3
NC_005091.alt2	NC_005091.alt1	79.1667	48	4635	4682	4048	3967	38	10
NC_005091.alt2	NC_005091.alt1	95.6522	46	38562	38607	34767	34812	44	2
NC_005091.alt2	NC_005091.alt1	1e+02	45	26673	26717	24040	23996	45	0
NC_005091.alt2	NC_005091.alt1	80.5556	36	5962	5997	4764	4799	29	7
NC_005091.alt1	NC_005091.ref	97.1534	6218	35485	41702	35179	41396	6041	177
NC_005091.alt1	NC_005091.ref	97.3026	5079	49210	54288	48961	54039	4942	137
NC_005091.alt1	NC_005091.ref	96.5833	2839	41787	44625	41481	44319	2742	97
NC_005091.alt1	NC_005091.ref	96.9281	2767	14120	16886	14120	16886	2682	85
NC_005091.alt1	NC_005091.ref	96.7091	2674	46446	49119	46284	48957	2586	88
NC_005091.alt1	NC_005091.ref	96.4272	2659	27475	30133	27562	30220	2564	95
NC_005091.alt1	NC_005091.ref	96.9857	2654	54289	56942	54289	56942	2574	80
NC_005091.alt1	NC_005091.ref	96.5779	2630	11396	14025	11396	14025	2540	90
NC_005091.alt1	NC_005091.ref	97.1396	2622	21381	24002	21381	24002	2547	75
NC_005091.alt1	NC_005091.ref	97.2067	2327	5093	7419	5093	7419	2262	65
NC_005091.alt1	NC_005091.ref	97.2469	2252	17011	19262	17011	19262	2190	62
NC_005091.alt1	NC_005091.ref	97.0734	2221	8128	10348	8128	10348	2156	65
NC_005091.alt1	NC_005091.ref	97.6599	1923	24355	26277	24355	26277	1878	45
NC_005091.alt1	NC_005091.ref	96.7176	1310	502	1811	502	1811	1267	43
NC_005091.alt1	NC_005091.ref	97.0471	1253	31102	32354	31045	32297	1216	37
NC_005091.alt1	NC_005091.ref	96.8215	1227	32759	33985	32453	33679	1188	39
NC_005091.alt1	NC_005091.ref	97.1275	1114	26278	27391	26365	27478	1082	32
NC_005091.alt1	NC_005091.ref	96.6314	1039	45310	46348	45148	46186	1004	35
NC_005091.alt1	NC_005091.ref	96.4363	926	20341	21266	20341	21266	893	33
NC_005091.alt1	NC_005091.ref	96.1494	857	2238	3094	2238	3094	824	33
NC_005091.alt1	NC_005091.ref	96.4158	837	4125	4961	4125	4961	807	30
NC_005091.alt1	NC_005091.ref	96.1165	824	3201	4024	3201	4024	792	32
NC_005091.alt1	NC_005091.ref	97.6744	817	10474	11290	10474	11290	798	19
NC_005091.alt1	NC_005091.ref	97.6584	726	34087	34812	33781	34506	709	17
NC_005091.alt1	NC_005091.ref	96.1149	592	44626	45217	44464	45055	569	23
NC_005091.alt1	NC_005091.ref	96.5932	499	7508	8006	7508	8006	482	17
NC_005091.alt1	NC_005091.ref	96.0986	487	34895	35381	34589	35075	468	19
NC_005091.alt1	NC_005091.ref	96.2963	405	3	407	3	407	390	15
NC_005091.alt1	NC_005091.ref	96.5517	348	19385	19732	19385	19732	336	12
NC_005091.alt1	NC_005091.ref	97.0845	343	19866	20208	19866	20208	333	10
NC_005091.alt1	NC_005091.ref	97.1831	284	30578	30861	30521	30804	276	8
NC_005091.alt1	NC_005091.ref	1e+02	249	32355	32603	54040	54288	249	0
NC_005091.alt1	NC_005091.ref	96.7742	217	57032	57248	57032	57248	210	7
NC_005091.alt1	NC_005091.ref	96.0526	152	1944	2095	1944	2095	146	6
NC_005091.alt1	NC_005091.ref	1e+02	149	30134	30282	30367	30219	149	0
NC_005091.alt1	NC_005091.ref	1e+02	145	30433	30577	44319	44463	145	0
NC_005091.alt1	NC_005091.ref	1e+02	137	2101	2237	2237	2101	137	0
NC_005091.alt1	NC_005091.ref	1e+02	133	19733	19865	19864	19732	133	0
NC_005091.alt1	NC_005091.ref	1e+02	132	1812	1943	1941	1810	132	0
NC_005091.alt1	NC_005091.ref	1e+02	132	20209	20340	20340	20209	132	0
NC_005091.alt1	NC_005091.ref	1e+02	132	30298	30429	30516	30385	132	0
NC_005091.alt1	NC_005091.ref	1e+02	131	4962	5092	5092	4962	131	0
NC_005091.alt1	NC_005091.ref	98.4375	128	24112	24239	24112	24239	126	2
NC_005091.alt1	NC_005091.ref	1e+02	122	10349	10470	10469	10348	122	0
NC_005091.alt1	NC_005091.ref	1e+02	122	19263	19384	19382	19261	122	0
NC_005091.alt1	NC_005091.ref	1e+02	121	8007	8127	8127	8007	121	0
NC_005091.alt1	NC_005091.ref	1e+02	121	16890	17010	17010	16890	121	0
NC_005091.alt1	NC_005091.ref	1e+02	116	30862	30977	30917	30802	116	0
NC_005091.alt1	NC_005091.ref	94.7826	115	24240	24354	24344	24230	109	6
NC_005091.alt1	NC_005091.ref	1e+02	112	57249	57360	57359	57248	112	0
NC_005091.alt1	NC_005091.ref	1e+02	111	21267	21377	21371	21261	111	0
NC_005091.alt1	NC_005091.ref	1e+02	109	24003	24111	24104	23996	109	0
NC_005091.alt1	NC_005091.ref	1e+02	106	3095	3200	3189	3084	106	0
NC_005091.alt1	NC_005091.ref	1e+02	105	11291	11395	11394	11290	105	0
NC_005091.alt1	NC_005091.ref	1e+02	104	32655	32758	32452	32349	104	0
NC_005091.alt1	NC_005091.ref	1e+02	103	35382	35484	35178	35076	103	0
NC_005091.alt1	NC_005091.ref	1e+02	101	33986	34086	33780	33680	101	0
NC_005091.alt1	NC_005091.ref	1e+02	98	4027	4124	4124	4027	98	0
NC_005091.alt1	NC_005091.ref	1e+02	97	46349	46445	46281	46185	97	0
NC_005091.alt1	NC_005091.ref	1e+02	94	408	501	499	406	94	0
NC_005091.alt1	NC_005091.ref	1e+02	94	14026	14119	14118	14025	94	0
NC_005091.alt1	NC_005091.ref	1e+02	93	31009	31101	31044	30952	93	0
NC_005091.alt1	NC_005091.ref	1e+02	92	45218	45309	45146	45055	92	0
NC_005091.alt1	NC_005091.ref	1e+02	92	57364	57455	57364	57455	92	0
NC_005091.alt1	NC_005091.ref	1e+02	89	56943	57031	57027	56939	89	0
NC_005091.alt1	NC_005091.ref	96.5909	88	7420	7507	7499	7412	85	3
NC_005091.alt1	NC_005091.ref	1e+02	88	49122	49209	26365	26278	88	0
NC_005091.alt1	NC_005091.ref	1e+02	84	41703	41786	41478	41395	84	0
NC_005091.alt1	NC_005091.ref	1e+02	83	27392	27474	27552	27470	83	0
NC_005091.alt1	NC_005091.ref	1e+02	82	34813	34894	34586	34505	82	0
NC_005091.alt1	NC_005091.ref	92.1569	51	32604	32654	32298	32348	47	4
NC_005091.alt1	NC_005091.alt2	92.2983	2467	14420	16886	15777	18243	2277	190
NC_005091.alt1	NC_005091.alt2	92.9336	2335	41786	44120	45520	47854	2170	165
NC_005091.alt1	NC_005091.alt2	93.2650	2049	5371	7419	6049	8097	1911	138
NC_005091.alt1	NC_005091.alt2	93.1294	1994	47124	49117	51579	53593	1857	137
NC_005091.alt1	NC_005091.alt2	93.7892	1755	51618	53372	56580	58334	1646	109
NC_005091.alt1	NC_005091.alt2	93.2537	1675	36438	38112	40296	41970	1562	113
NC_005091.alt1	NC_005091.alt2	92.5824	1456	11396	12851	12524	13979	1348	108
NC_005091.alt1	NC_005091.alt2	93.6288	1444	54479	55922	60582	62025	1352	92
NC_005091.alt1	NC_005091.alt2	93.1559	1315	28042	29356	30993	32307	1225	90
NC_005091.alt1	NC_005091.alt2	93.4866	1305	39456	40760	43279	44583	1220	85
NC_005091.alt1	NC_005091.alt2	93.5385	1300	49729	51028	54399	55698	1216	84
NC_005091.alt1	NC_005091.alt2	92.7188	1291	22712	24002	25121	26411	1197	94
NC_005091.alt1	NC_005091.alt2	92.9796	1225	32761	33985	36019	37243	1139	86
NC_005091.alt1	NC_005091.alt2	93.1743	1216	596	1811	718	1933	1133	83
NC_005091.alt1	NC_005091.alt2	94.0692	1214	8128	9341	8806	10019	1142	72
NC_005091.alt1	NC_005091.alt2	92.8150	1016	55923	56938	62164	63179	943	73
NC_005091.alt1	NC_005091.alt2	92.8320	851	40850	41700	44584	45434	790	61
NC_005091.alt1	NC_005091.alt2	91.8689	824	3201	4024	3602	4425	757	67
NC_005091.alt1	NC_005091.alt2	95.1252	759	17014	17772	18371	19129	722	37
NC_005091.alt1	NC_005091.alt2	93.3884	726	20341	21066	22816	23541	678	48
NC_005091.alt1	NC_005091.alt2	94.3448	725	26278	27002	28740	29464	684	41
NC_005091.alt1	NC_005091.alt2	93.9944	716	17913	18628	19577	20292	673	43
NC_005091.alt1	NC_005091.alt2	94.6479	710	31406	32115	34769	35478	672	38
NC_005091.alt1	NC_005091.alt2	92.9927	685	21381	22065	23675	24359	637	48
NC_005091.alt1	NC_005091.alt2	91.5556	675	29459	30133	32717	33391	618	57
NC_005091.alt1	NC_005091.alt2	95.5626	631	35807	36437	39541	40171	603	28
NC_005091.alt1	NC_005091.alt2	94.8247	599	24742	25340	27500	28098	568	31
NC_005091.alt1	NC_005091.alt2	92.5676	592	44626	45217	48625	49216	548	44
NC_005091.alt1	NC_005091.alt2	92.9795	584	51031	51614	55885	56468	543	41
NC_005091.alt1	NC_005091.alt2	96.3028	568	10470	11037	11493	12060	547	21
NC_005091.alt1	NC_005091.alt2	94.1799	567	27475	28041	30280	30846	534	33
NC_005091.alt1	NC_005091.alt2	92.6655	559	45790	46348	50061	50619	518	41
NC_005091.alt1	NC_005091.alt2	93.4579	535	9814	10348	10837	11371	500	35
NC_005091.alt1	NC_005091.alt2	93.7008	508	13518	14025	14708	15215	476	32
NC_005091.alt1	NC_005091.alt2	96.8379	506	53658	54163	58998	59503	490	16
NC_005091.alt1	NC_005091.alt2	93.0693	505	44121	44625	47976	48480	470	35
NC_005091.alt1	NC_005091.alt2	92.0477	503	7501	8003	8179	8681	463	40
NC_005091.alt1	NC_005091.alt2	89.7590	498	2364	2861	2571	3096	447	51
NC_005091.alt1	NC_005091.alt2	92.5373	469	9345	9813	10215	10683	434	35
NC_005091.alt1	NC_005091.alt2	93.8190	453	18630	19082	20491	20943	425	28
NC_005091.alt1	NC_005091.alt2	92.3788	433	4236	4668	4768	5200	400	33
NC_005091.alt1	NC_005091.alt2	93.4307	411	12852	13262	14061	14471	384	27
NC_005091.alt1	NC_005091.alt2	93.8272	405	3	407	3	407	380	25
NC_005091.alt1	NC_005091.alt2	95.8333	384	24355	24738	26961	27344	368	16
NC_005091.alt1	NC_005091.alt2	96.6759	361	49368	49728	53891	54251	349	12
NC_005091.alt1	NC_005091.alt2	93.6416	346	46453	46798	50724	51069	324	22
NC_005091.alt1	NC_005091.alt2	94.1176	306	38921	39226	42963	43268	288	18
NC_005091.alt1	NC_005091.alt2	94.0789	304	31102	31405	34361	34664	286	18
NC_005091.alt1	NC_005091.alt2	96.6555	299	14121	14419	15311	15609	289	10
NC_005091.alt1	NC_005091.alt2	92.2034	295	25468	25762	28105	28399	272	23
NC_005091.alt1	NC_005091.alt2	92.0690	290	22269	22558	24833	25122	267	23
NC_005091.alt1	NC_005091.alt2	94.7183	284	46799	47082	51195	51478	269	15
NC_005091.alt1	NC_005091.alt2	93.6170	282	30580	30861	33839	34120	264	18
NC_005091.alt1	NC_005091.alt2	93.5714	280	53376	53655	58557	58836	262	18
NC_005091.alt1	NC_005091.alt2	94.9458	277	5093	5369	5670	5946	263	14
NC_005091.alt1	NC_005091.alt2	95.9707	273	38647	38919	42543	42815	262	11
NC_005091.alt1	NC_005091.alt2	94.4238	269	45310	45578	49309	49577	254	15
NC_005091.alt1	NC_005091.alt2	94.7566	267	38113	38379	42114	42380	253	14
NC_005091.alt1	NC_005091.alt2	96.2121	264	34549	34812	38165	38428	254	10
NC_005091.alt1	NC_005091.alt2	97.7099	262	25763	26024	5462	5201	256	6
NC_005091.alt1	NC_005091.alt2	92.8854	253	11038	11290	12166	12418	235	18
NC_005091.alt1	NC_005091.alt2	94.4664	253	26025	26277	28400	28652	239	14
NC_005091.alt1	NC_005091.alt2	97.5904	249	32355	32603	59969	60217	243	6
NC_005091.alt1	NC_005091.alt2	97.1545	246	19866	20111	22216	22461	239	7
NC_005091.alt1	NC_005091.alt2	94.1423	239	32116	32354	35623	35861	225	14
NC_005091.alt1	NC_005091.alt2	95.2991	234	19385	19618	21343	21576	223	11
NC_005091.alt1	NC_005091.alt2	90.5983	234	35148	35381	39066	39299	212	22
NC_005091.alt1	NC_005091.alt2	94.8498	233	2862	3094	3263	3495	221	12
NC_005091.alt1	NC_005091.alt2	96.9432	229	39227	39455	58335	58563	222	7
NC_005091.alt1	NC_005091.alt2	98.2301	226	27004	27229	29621	29846	222	4
NC_005091.alt1	NC_005091.alt2	95.4338	219	34328	34546	37856	38074	209	10
NC_005091.alt1	NC_005091.alt2	94.4700	217	57032	57248	63273	63489	205	12
NC_005091.alt1	NC_005091.alt2	98.5782	211	45579	45789	49660	49870	208	3
NC_005091.alt1	NC_005091.alt2	96.0396	202	4760	4961	32523	32322	194	8
NC_005091.alt1	NC_005091.alt2	93	200	22066	22265	24475	24674	186	14
NC_005091.alt1	NC_005091.alt2	94.9749	199	34949	35147	38744	38942	189	10
NC_005091.alt1	NC_005091.alt2	97.4227	194	38380	38573	3046	3239	189	5
NC_005091.alt1	NC_005091.alt2	95.7895	190	54289	54478	60218	60407	182	8
NC_005091.alt1	NC_005091.alt2	98.3696	184	35623	35806	55698	55881	181	3
NC_005091.alt1	NC_005091.alt2	92.2222	180	19083	19262	21041	21220	166	14
NC_005091.alt1	NC_005091.alt2	94.4134	179	21067	21245	37672	37494	169	10
NC_005091.alt1	NC_005091.alt2	91.3580	162	27230	27391	30035	30196	148	14
NC_005091.alt1	NC_005091.alt2	93.0818	159	30134	30292	33538	33380	148	11
NC_005091.alt1	NC_005091.alt2	94.9045	157	49210	49366	53599	53755	149	8
NC_005091.alt1	NC_005091.alt2	96.0784	153	13365	13517	33689	33537	147	6
NC_005091.alt1	NC_005091.alt2	98.0392	153	22559	22711	24680	24832	150	3
NC_005091.alt1	NC_005091.alt2	94.0789	152	1944	2095	2066	2217	143	9
NC_005091.alt1	NC_005091.alt2	93.8776	147	34087	34233	37345	37491	138	9
NC_005091.alt1	NC_005091.alt2	97.2414	145	30433	30577	48480	48624	141	4
NC_005091.alt1	NC_005091.alt2	97.0803	137	2101	2237	2359	2223	133	4
NC_005091.alt1	NC_005091.alt2	94.1606	137	17773	17909	19321	19462	129	8
NC_005091.alt1	NC_005091.alt2	95.5556	135	35485	35619	39403	39537	129	6
NC_005091.alt1	NC_005091.alt2	97.7444	133	19733	19865	22214	22082	130	3
NC_005091.alt1	NC_005091.alt2	97.7273	132	1812	1943	2063	1932	129	3
NC_005091.alt1	NC_005091.alt2	93.9394	132	20209	20340	22815	22684	124	8
NC_005091.alt1	NC_005091.alt2	92.4242	132	30298	30429	33832	33701	122	10
NC_005091.alt1	NC_005091.alt2	94.4882	127	25341	25467	47855	47981	120	7
NC_005091.alt1	NC_005091.alt2	92.8571	126	2238	2363	2360	2485	117	9
NC_005091.alt1	NC_005091.alt2	94.3089	123	54166	54288	59679	59801	116	7
NC_005091.alt1	NC_005091.alt2	96.7213	122	19263	19384	21340	21219	118	4
NC_005091.alt1	NC_005091.alt2	95.0413	121	8007	8127	8805	8685	115	6
NC_005091.alt1	NC_005091.alt2	99.1736	121	16890	17010	18367	18247	120	1
NC_005091.alt1	NC_005091.alt2	95.7983	119	10349	10467	11492	11374	114	5
NC_005091.alt1	NC_005091.alt2	99.1525	118	4962	5079	5669	5552	117	1
NC_005091.alt1	NC_005091.alt2	96.5812	117	21261	21377	23671	23555	113	4
NC_005091.alt1	NC_005091.alt2	93.9655	116	30862	30977	34233	34118	109	7
NC_005091.alt1	NC_005091.alt2	93.0435	115	24240	24354	26950	26836	107	8
NC_005091.alt1	NC_005091.alt2	98.2456	114	19619	19732	21771	21884	112	2
NC_005091.alt1	NC_005091.alt2	91.9643	112	57249	57360	63600	63489	103	9
NC_005091.alt1	NC_005091.alt2	94.4954	109	4125	4233	4526	4634	103	6
NC_005091.alt1	NC_005091.alt2	1e+02	109	24003	24111	26710	26602	109	0
NC_005091.alt1	NC_005091.alt2	95.2830	106	3095	3200	3590	3485	101	5
NC_005091.alt1	NC_005091.alt2	92.3810	105	11291	11395	12522	12418	97	8
NC_005091.alt1	NC_005091.alt2	96.1538	104	32655	32758	36016	35913	100	4
NC_005091.alt1	NC_005091.alt2	91.3462	104	46349	46452	50714	50611	95	9
NC_005091.alt1	NC_005091.alt2	89.2157	102	13263	13364	14598	14699	91	11
NC_005091.alt1	NC_005091.alt2	97.0588	102	29357	29458	32525	32626	99	3
NC_005091.alt1	NC_005091.alt2	96.0784	102	35382	35483	39402	39301	98	4
NC_005091.alt1	NC_005091.alt2	94.0594	101	33986	34086	37344	37244	95	6
NC_005091.alt1	NC_005091.alt2	92.8571	98	4027	4124	4525	4428	91	7
NC_005091.alt1	NC_005091.alt2	89.6907	97	20112	20208	22587	22683	87	10
NC_005091.alt1	NC_005091.alt2	94.6809	94	408	501	499	406	89	5
NC_005091.alt1	NC_005091.alt2	95.7447	94	502	595	502	595	90	4
NC_005091.alt1	NC_005091.alt2	95.7447	94	14026	14119	15308	15215	90	4
NC_005091.alt1	NC_005091.alt2	95.6522	92	31009	31100	34360	34269	88	4
NC_005091.alt1	NC_005091.alt2	97.8261	92	45218	45309	49307	49216	90	2
NC_005091.alt1	NC_005091.alt2	93.4783	92	57364	57455	63605	63696	86	6
NC_005091.alt1	NC_005091.alt2	95.6044	91	34237	34327	37676	37766	87	4
NC_005091.alt1	NC_005091.alt2	93.3333	90	56939	57028	63272	63183	84	6
NC_005091.alt1	NC_005091.alt2	93.2584	89	4671	4759	5465	5553	83	6
NC_005091.alt1	NC_005091.alt2	93.1818	88	49122	49209	28740	28653	82	6
NC_005091.alt1	NC_005091.alt2	97.7011	87	40761	40847	42542	42456	85	2
NC_005091.alt1	NC_005091.alt2	97.6471	85	41701	41785	45520	45436	83	2
NC_005091.alt1	NC_005091.alt2	95.1807	83	27392	27474	30270	30188	79	4
NC_005091.alt1	NC_005091.alt2	1e+02	82	34813	34894	38687	38606	82	0
NC_005091.alt1	NC_005091.alt2	96.2963	81	7420	7500	8177	8097	78	3
NC_005091.alt1	NC_005091.alt2	91.4286	70	38577	38646	42384	42453	64	6
NC_005091.alt1	NC_005091.alt2	98.5075	67	24112	24178	26521	26587	66	1
NC_005091.alt1	NC_005091.alt2	96.7213	61	24179	24239	26785	26845	59	2
NC_005091.alt1	NC_005091.alt2	88.2353	51	32604	32654	35862	35912	45	6
NC_005091.alt1	NC_005091.alt2	94.1176	51	34895	34945	38511	38561	48	3
NC_005091.alt1	NC_025457.alt1	40.5797	69	47951	48019	359	418	28	41
NC_005091.alt1	NC_025457.alt1	50.7463	67	27194	27260	24600	24519	34	33
NC_005091.alt1	NC_025457.alt1	48.3333	60	18939	18998	32401	32309	29	31
NC_005091.alt1	NC_025457.alt1	55.9322	59	39831	39889	30293	30210	33	26
NC_005091.alt1	NC_025457.alt1	58.6207	58	25853	25910	7136	7045	34	24
NC_005091.alt1	NC_025457.alt1	40.3509	57	46795	46851	12502	12551	23	34
NC_005091.alt1	NC_025457.alt1	55.3571	56	14773	14828	16707	16645	31	25
NC_005091.alt1	NC_025457.alt1	5e+01	56	38818	38873	39272	39330	28	28
NC_005091.alt1	NC_025457.alt1	65.3846	52	32658	32709	38522	38561	34	18
NC_005091.alt1	NC_025457.alt1	54.9020	51	5129	5179	14469	14520	28	23
NC_005091.alt1	NC_025457.alt1	53.0612	49	14543	14591	33603	33564	26	23
NC_005091.alt1	NC_025457.alt1	64.5833	48	18279	18326	17054	17095	31	17
NC_005091.alt1	NC_025457.alt1	55.3191	47	9456	9502	31663	31623	26	21
NC_005091.alt1	NC_025457.alt1	59.5745	47	29915	29961	13454	13503	28	19
NC_005091.alt1	NC_025457.alt1	56.5217	46	37888	37933	15039	15100	26	20
NC_005091.alt1	NC_025457.alt1	59.5238	42	2168	2209	34072	34108	25	17
NC_005091.alt1	NC_025457.alt1	5e+01	42	26216	26257	21596	21630	21	21
NC_005091.alt1	NC_025457.alt1	60.9756	41	809	849	38866	38820	25	16
NC_005091.alt1	NC_025457.alt1	81.5789	38	45742	45779	7361	7280	31	7
NC_005091.alt1	NC_025457.alt1	72.9730	37	20434	20470	18232	18266	27	10
NC_005091.alt1	NC_025457.alt1	62.1622	37	54960	54996	30189	30152	23	14
NC_005091.alt1	NC_025457.alt1	68.5714	35	53815	53849	18212	18240	24	11
NC_005091.alt1	NC_010807.alt1	59.7938	97	20412	20508	2176	2080	58	39
NC_005091.alt1	NC_010807.alt1	52.0548	73	9948	10020	37455	37549	38	35
NC_005091.alt1	NC_010807.alt1	49.3151	73	47195	47267	24640	24582	36	37
NC_005091.alt1	NC_010807.alt1	6e+01	70	151	220	2472	2390	42	28
NC_005091.alt1	NC_010807.alt1	52.1739	69	54525	54593	21050	20943	36	33
NC_005091.alt1	NC_010807.alt1	48.5294	68	35849	35916	2914	2854	33	35
NC_005091.alt1	NC_010807.alt1	56.25	64	7576	7639	14187	14114	36	28
NC_005091.alt1	NC_010807.alt1	57.1429	63	44413	44475	22012	21919	36	27
NC_005091.alt1	NC_010807.alt1	56.4516	62	22779	22840	35530	35433	35	27
NC_005091.alt1	NC_010807.alt1	65.5738	61	37456	37516	14229	14168	40	21
NC_005091.alt1	NC_010807.alt1	54.0984	61	38458	38518	30507	30560	33	28
NC_005091.alt1	NC_010807.alt1	61.6667	60	46476	46535	25405	25313	37	23
NC_005091.alt1	NC_010807.alt1	57.6271	59	26110	26168	20936	20857	34	25
NC_005091.alt1	NC_010807.alt1	37.2881	59	52029	52087	24238	24288	22	37
NC_005091.alt1	NC_010807.alt1	59.3220	59	57254	57312	37469	37373	35	24
NC_005091.alt1	NC_010807.alt1	53.4483	58	47340	47397	26549	26465	31	27
NC_005091.alt1	NC_010807.alt1	54.3860	57	15106	15162	1475	1403	31	26
NC_005091.alt1	NC_010807.alt1	58.9286	56	1132	1187	5410	5347	33	23
NC_005091.alt1	NC_010807.alt1	63.6364	55	31067	31121	14280	14211	35	20
NC_005091.alt1	NC_010807.alt1	67.2727	55	46693	46747	21843	21777	37	18
NC_005091.alt1	NC_010807.alt1	48.1481	54	33156	33209	7473	7514	26	28
NC_005091.alt1	NC_010807.alt1	72.2222	54	38880	38933	30129	30235	39	15
NC_005091.alt1	NC_010807.alt1	55.5556	54	54802	54855	9399	9445	30	24
NC_005091.alt1	NC_010807.alt1	62.9630	54	56033	56086	12107	12175	34	20
NC_005091.alt1	NC_010807.alt1	51.9231	52	1613	1664	24212	24291	27	25
NC_005091.alt1	NC_010807.alt1	55.7692	52	4322	4373	9423	9379	29	23
NC_005091.alt1	NC_010807.alt1	58.8235	51	21777	21827	10916	11003	30	21
NC_005091.alt1	NC_010807.alt1	56.8627	51	55654	55704	31151	31194	29	22
NC_005091.alt1	NC_010807.alt1	62	50	47882	47931	28666	28746	31	19
NC_005091.alt1	NC_010807.alt1	59.1837	49	5593	5641	26407	26325	29	20
NC_005091.alt1	NC_010807.alt1	55.1020	49	46883	46931	3596	3534	27	22
NC_005091.alt1	NC_010807.alt1	55.1020	49	51182	51230	29701	29742	27	22
NC_005091.alt1	NC_010807.alt1	57.1429	49	53524	53572	23889	23857	28	21
NC_005091.alt1	NC_010807.alt1	5e+01	48	49872	49919	18107	18052	24	24
NC_005091.alt1	NC_010807.alt1	63.8298	47	7445	7491	20041	19952	30	17
NC_005091.alt1	NC_010807.alt1	46.8085	47	55361	55407	25156	25192	22	25
NC_005091.alt1	NC_010807.alt1	53.3333	45	10454	10498	3344	3311	24	21
NC_005091.alt1	NC_010807.alt1	48.8889	45	26593	26637	1961	1924	22	23
NC_005091.alt1	NC_010807.alt1	64.4444	45	27785	27829	26366	26313	29	16
NC_005091.alt1	NC_010807.alt1	67.4419	43	8450	8492	27318	27362	29	14
NC_005091.alt1	NC_010807.alt1	60.4651	43	15207	15249	6830	6864	26	17
NC_005091.alt1	NC_010807.alt1	54.7619	42	21828	21869	2384	2309	23	19
NC_005091.alt1	NC_010807.alt1	71.4286	42	25840	25881	20301	20227	30	12
NC_005091.alt1	NC_010807.alt1	63.4146	41	21642	21682	1164	1134	26	15
NC_005091.alt1	NC_010807.alt1	58.5366	41	26823	26863	24090	24124	24	17
NC_005091.alt1	NC_010807.alt1	67.5	40	8332	8371	1547	1508	27	13
NC_005091.alt1	NC_010807.alt1	64.1026	39	35786	35824	28790	28822	25	14
NC_005091.alt1	NC_010807.alt1	64.1026	39	37039	37077	30058	30027	25	14
NC_005091.alt1	NC_010807.alt1	82.0513	39	39548	39586	731	691	32	7
NC_005091.alt1	NC_010807.alt1	65.7895	38	5376	5413	36744	36772	25	13
NC_005091.alt1	NC_010807.alt1	64.8649	37	18066	18102	25574	25503	24	13
NC_005091.alt1	NC_010807.alt1	75	36	28108	28143	21723	21668	27	9
NC_005091.alt1	NC_010807.alt1	66.6667	36	45829	45864	28766	28733	24	12
NC_005091.alt1	NC_010807.alt1	72.2222	36	48852	48887	10717	10669	26	10
NC_005091.alt1	NC_010807.alt1	86.1111	36	55122	55157	1655	1624	31	5
NC_005091.alt1	NC_010807.alt1	65.7143	35	18621	18655	25954	26020	23	12
NC_005091.alt1	NC_010807.alt1	65.7143	35	23471	23505	37793	37817	23	12
NC_005091.alt1	NC_010807.alt1	62.8571	35	54378	54412	17977	17943	22	13
NC_005091.alt1	NC_002486.ref	52.9412	68	33462	33529	12600	12525	36	32
NC_005091.alt1	NC_002486.ref	49.1228	57	7459	7515	18117	18061	28	29
NC_005091.alt1	NC_002486.ref	52.6316	57	47110	47166	14173	14090	30	27
NC_005091.alt1	NC_002486.ref	57.4074	54	21433	21486	14098	14036	31	23
NC_005091.alt1	NC_002486.ref	46.2963	54	22631	22684	35962	35921	25	29
NC_005091.alt1	NC_002486.ref	52.8302	53	43453	43505	24653	24741	28	25
NC_005091.alt1	NC_002486.ref	59.6154	52	47013	47064	5537	5467	31	21
NC_005091.alt1	NC_002486.ref	45.8333	48	6931	6978	42153	42222	22	26
NC_005091.alt1	NC_002486.ref	64.2857	42	33875	33916	17148	17086	27	15
NC_005091.alt1	NC_002486.ref	57.5	40	4963	5002	11967	12040	23	17
NC_005091.alt1	NC_002486.ref	7e+01	40	51381	51420	6716	6792	28	12
NC_005091.alt1	NC_002486.ref	56.4103	39	45349	45387	23320	23292	22	17
NC_005091.alt1	NC_002486.ref	69.2308	39	47405	47443	12539	12470	27	12
NC_005091.alt1	NC_002486.ref	72.9730	37	25947	25983	36575	36615	27	10
NC_005091.ref	NC_005091.alt1	97.1534	6218	35179	41396	35485	41702	6041	177
NC_005091.ref	NC_005091.alt1	97.3026	5079	48961	54039	49210	54288	4942	137
NC_005091.ref	NC_005091.alt1	96.5833	2839	41481	44319	41787	44625	2742	97
NC_005091.ref	NC_005091.alt1	96.9281	2767	14120	16886	14120	16886	2682	85
NC_005091.ref	NC_005091.alt1	96.7091	2674	46284	48957	46446	49119	2586	88
NC_005091.ref	NC_005091.alt1	96.4272	2659	27562	30220	27475	30133	2564	95
NC_005091.ref	NC_005091.alt1	96.9857	2654	54289	56942	54289	56942	2574	80
NC_005091.ref	NC_005091.alt1	96.5779	2630	11396	14025	11396	14025	2540	90
NC_005091.ref	NC_005091.alt1	97.1396	2622	21381	24002	21381	24002	2547	75
NC_005091.ref	NC_005091.alt1	97.2067	2327	5093	7419	5093	7419	2262	65
NC_005091.ref	NC_005091.alt1	97.2469	2252	17011	19262	17011	19262	2190	62
NC_005091.ref	NC_005091.alt1	97.0734	2221	8128	10348	8128	10348	2156	65
NC_005091.ref	NC_005091.alt1	97.6599	1923	24355	26277	24355	26277	1878	45
NC_005091.ref	NC_005091.alt1	96.7176	1310	502	1811	502	1811	1267	43
NC_005091.ref	NC_005091.alt1	97.0471	1253	31045	32297	31102	32354	1216	37
NC_005091.ref	NC_005091.alt1	96.8215	1227	32453	33679	32759	33985	1188	39
NC_005091.ref	NC_005091.alt1	97.1249	1113	26366	27478	26279	27391	1081	32
NC_005091.ref	NC_005091.alt1	96.6314	1039	45148	46186	45310	46348	1004	35
NC_005091.ref	NC_005091.alt1	96.4363	926	20341	21266	20341	21266	893	33
NC_005091.ref	NC_005091.alt1	96.1494	857	2238	3094	2238	3094	824	33
NC_005091.ref	NC_005091.alt1	96.1165	824	3201	4024	3201	4024	792	32
NC_005091.ref	NC_005091.alt1	97.6744	817	10474	11290	10474	11290	798	19
NC_005091.ref	NC_005091.alt1	96.6708	811	4151	4961	4151	4961	784	27
NC_005091.ref	NC_005091.alt1	97.6584	726	33781	34506	34087	34812	709	17
NC_005091.ref	NC_005091.alt1	96.1149	592	44464	45055	44626	45217	569	23
NC_005091.ref	NC_005091.alt1	96.5932	499	7508	8006	7508	8006	482	17
NC_005091.ref	NC_005091.alt1	96.0986	487	34589	35075	34895	35381	468	19
NC_005091.ref	NC_005091.alt1	96.2963	405	3	407	3	407	390	15
NC_005091.ref	NC_005091.alt1	96.5517	348	19385	19732	19385	19732	336	12
NC_005091.ref	NC_005091.alt1	97.0845	343	19866	20208	19866	20208	333	10
NC_005091.ref	NC_005091.alt1	97.1831	284	30521	30804	30578	30861	276	8
NC_005091.ref	NC_005091.alt1	1e+02	249	54040	54288	32355	32603	249	0
NC_005091.ref	NC_005091.alt1	96.7742	217	57032	57248	57032	57248	210	7
NC_005091.ref	NC_005091.alt1	96.0526	152	1944	2095	1944	2095	146	6
NC_005091.ref	NC_005091.alt1	1e+02	149	30221	30369	30280	30132	149	0
NC_005091.ref	NC_005091.alt1	1e+02	144	44320	44463	30434	30577	144	0
NC_005091.ref	NC_005091.alt1	1e+02	137	2101	2237	2237	2101	137	0
NC_005091.ref	NC_005091.alt1	1e+02	133	19733	19865	19864	19732	133	0
NC_005091.ref	NC_005091.alt1	1e+02	132	1812	1943	1941	1810	132	0
NC_005091.ref	NC_005091.alt1	1e+02	132	20209	20340	20340	20209	132	0
NC_005091.ref	NC_005091.alt1	1e+02	132	30385	30516	30429	30298	132	0
NC_005091.ref	NC_005091.alt1	1e+02	131	4962	5092	5092	4962	131	0
NC_005091.ref	NC_005091.alt1	98.4375	128	24112	24239	24112	24239	126	2
NC_005091.ref	NC_005091.alt1	91.9355	124	4027	4150	4124	3967	114	10
NC_005091.ref	NC_005091.alt1	1e+02	122	10349	10470	10469	10348	122	0
NC_005091.ref	NC_005091.alt1	1e+02	122	19263	19384	19382	19261	122	0
NC_005091.ref	NC_005091.alt1	1e+02	121	8007	8127	8127	8007	121	0
NC_005091.ref	NC_005091.alt1	1e+02	121	16890	17010	17010	16890	121	0
NC_005091.ref	NC_005091.alt1	1e+02	116	30805	30920	30974	30859	116	0
NC_005091.ref	NC_005091.alt1	94.7826	115	24240	24354	24344	24230	109	6
NC_005091.ref	NC_005091.alt1	1e+02	112	57249	57360	57359	57248	112	0
NC_005091.ref	NC_005091.alt1	1e+02	111	21267	21377	21371	21261	111	0
NC_005091.ref	NC_005091.alt1	1e+02	109	24003	24111	24104	23996	109	0
NC_005091.ref	NC_005091.alt1	1e+02	106	3095	3200	3189	3084	106	0
NC_005091.ref	NC_005091.alt1	1e+02	105	11291	11395	11394	11290	105	0
NC_005091.ref	NC_005091.alt1	1e+02	104	32349	32452	32758	32655	104	0
NC_005091.ref	NC_005091.alt1	1e+02	103	35076	35178	35484	35382	103	0
NC_005091.ref	NC_005091.alt1	1e+02	101	33680	33780	34086	33986	101	0
NC_005091.ref	NC_005091.alt1	1e+02	97	46187	46283	46443	46347	97	0
NC_005091.ref	NC_005091.alt1	1e+02	94	408	501	499	406	94	0
NC_005091.ref	NC_005091.alt1	1e+02	94	14026	14119	14118	14025	94	0
NC_005091.ref	NC_005091.alt1	1e+02	93	30952	31044	31101	31009	93	0
NC_005091.ref	NC_005091.alt1	1e+02	92	45056	45147	45308	45217	92	0
NC_005091.ref	NC_005091.alt1	1e+02	92	57364	57455	57364	57455	92	0
NC_005091.ref	NC_005091.alt1	1e+02	89	56943	57031	57027	56939	89	0
NC_005091.ref	NC_005091.alt1	96.5909	88	7420	7507	7499	7412	85	3
NC_005091.ref	NC_005091.alt1	1e+02	88	26278	26365	49209	49122	88	0
NC_005091.ref	NC_005091.alt1	1e+02	84	41397	41480	41784	41701	84	0
NC_005091.ref	NC_005091.alt1	1e+02	83	27479	27561	27465	27383	83	0
NC_005091.ref	NC_005091.alt1	1e+02	82	34507	34588	34892	34811	82	0
NC_005091.ref	NC_005091.alt1	92.1569	51	32298	32348	32604	32654	47	4
NC_005091.alt1	NC_002486.alt	52.9412	68	33462	33529	43024	42949	36	32
NC_005091.alt1	NC_002486.alt	49.1228	57	7459	7515	27520	27576	28	29
NC_005091.alt1	NC_002486.alt	52.6316	57	47110	47166	44597	44514	30	27
NC_005091.alt1	NC_002486.alt	57.4074	54	21433	21486	44522	44460	31	23
NC_005091.alt1	NC_002486.alt	46.2963	54	22631	22684	5538	5497	25	29
NC_005091.alt1	NC_002486.alt	52.8302	53	43453	43505	20984	20896	28	25
NC_005091.alt1	NC_002486.alt	59.6154	52	47013	47064	35961	35891	31	21
NC_005091.alt1	NC_002486.alt	45.8333	48	6931	6978	11729	11798	22	26
NC_005091.alt1	NC_002486.alt	64.2857	42	33875	33916	28489	28551	27	15
NC_005091.alt1	NC_002486.alt	57.5	40	4963	5002	42391	42464	23	17
NC_005091.alt1	NC_002486.alt	7e+01	40	51381	51420	37140	37216	28	12
NC_005091.alt1	NC_002486.alt	56.4103	39	45349	45387	22317	22345	22	17
NC_005091.alt1	NC_002486.alt	69.2308	39	47405	47443	42963	42894	27	12
NC_005091.alt1	NC_002486.alt	72.9730	37	25947	25983	6151	6191	27	10
NC_005091.alt1	NC_010807.alt2	51.9608	102	46947	47048	33628	33465	53	49
NC_005091.alt1	NC_010807.alt2	54.6392	97	20412	20508	2731	2635	53	44
NC_005091.alt1	NC_010807.alt2	52.0548	73	9948	10020	39195	39289	38	35
NC_005091.alt1	NC_010807.alt2	58.5714	70	151	220	3196	3114	41	29
NC_005091.alt1	NC_010807.alt2	52.1739	69	54525	54593	21994	21887	36	33
NC_005091.alt1	NC_010807.alt2	48.4848	66	10701	10766	25614	25534	32	34
NC_005091.alt1	NC_010807.alt2	56.25	64	7576	7639	15538	15465	36	28
NC_005091.alt1	NC_010807.alt2	56.4516	62	22779	22840	37097	37000	35	27
NC_005091.alt1	NC_010807.alt2	65.5738	61	37456	37516	15580	15519	40	21
NC_005091.alt1	NC_010807.alt2	54.0984	61	38458	38518	31818	31871	33	28
NC_005091.alt1	NC_010807.alt2	61.6667	60	46476	46535	26438	26346	37	23
NC_005091.alt1	NC_010807.alt2	37.2881	59	52029	52087	25271	25321	22	37
NC_005091.alt1	NC_010807.alt2	59.3220	59	57254	57312	39209	39113	35	24
NC_005091.alt1	NC_010807.alt2	57.1429	56	1132	1187	6474	6411	32	24
NC_005091.alt1	NC_010807.alt2	51.7857	56	7763	7818	2373	2300	29	27
NC_005091.alt1	NC_010807.alt2	63.6364	55	31067	31121	15631	15562	35	20
NC_005091.alt1	NC_010807.alt2	72.2222	54	38880	38933	31440	31546	39	15
NC_005091.alt1	NC_010807.alt2	55.5556	54	54802	54855	10721	10767	30	24
NC_005091.alt1	NC_010807.alt2	62.9630	54	56033	56086	13365	13433	34	20
NC_005091.alt1	NC_010807.alt2	51.9231	52	1613	1664	25245	25324	27	25
NC_005091.alt1	NC_010807.alt2	55.7692	52	4322	4373	10745	10701	29	23
NC_005091.alt1	NC_010807.alt2	57.6923	52	20288	20339	11506	11575	30	22
NC_005091.alt1	NC_010807.alt2	43.1373	51	543	593	11024	11063	22	29
NC_005091.alt1	NC_010807.alt2	54.9020	51	45571	45621	18565	18503	28	23
NC_005091.alt1	NC_010807.alt2	58.8235	51	55654	55704	32462	32505	30	21
NC_005091.alt1	NC_010807.alt2	62	50	47882	47931	29699	29779	31	19
NC_005091.alt1	NC_010807.alt2	59.1837	49	5593	5641	27440	27358	29	20
NC_005091.alt1	NC_010807.alt2	61.2245	49	8663	8711	33718	33794	30	19
NC_005091.alt1	NC_010807.alt2	57.1429	49	46883	46931	4500	4438	28	21
NC_005091.alt1	NC_010807.alt2	5e+01	48	49872	49919	19167	19112	24	24
NC_005091.alt1	NC_010807.alt2	63.8298	47	5872	5918	28339	28298	30	17
NC_005091.alt1	NC_010807.alt2	53.3333	45	10454	10498	4248	4215	24	21
NC_005091.alt1	NC_010807.alt2	62.2222	45	27785	27829	27399	27346	28	17
NC_005091.alt1	NC_010807.alt2	66.6667	45	53031	53075	36290	36220	30	15
NC_005091.alt1	NC_010807.alt2	67.4419	43	8450	8492	28351	28395	29	14
NC_005091.alt1	NC_010807.alt2	60.4651	43	15207	15249	8069	8035	26	17
NC_005091.alt1	NC_010807.alt2	71.4286	42	25840	25881	21245	21171	30	12
NC_005091.alt1	NC_010807.alt2	66.6667	42	51156	51197	21824	21859	28	14
NC_005091.alt1	NC_010807.alt2	60.9756	41	12728	12768	29287	29247	25	16
NC_005091.alt1	NC_010807.alt2	63.4146	41	21642	21682	1719	1689	26	15
NC_005091.alt1	NC_010807.alt2	58.5366	41	26823	26863	25123	25157	24	17
NC_005091.alt1	NC_010807.alt2	8e+01	40	45763	45802	5889	5858	32	8
NC_005091.alt1	NC_010807.alt2	64.1026	39	37039	37077	31369	31338	25	14
NC_005091.alt1	NC_010807.alt2	82.0513	39	39548	39586	1286	1246	32	7
NC_005091.alt1	NC_010807.alt2	65.7895	38	5376	5413	38484	38510	25	13
NC_005091.alt1	NC_010807.alt2	5e+01	38	49110	49147	2727	2757	19	19
NC_005091.alt1	NC_010807.alt2	64.8649	37	18066	18102	26607	26536	24	13
NC_005091.alt1	NC_010807.alt2	67.5676	37	32123	32159	29441	29405	25	12
NC_005091.alt1	NC_010807.alt2	72.2222	36	28108	28143	22667	22612	26	10
NC_005091.alt1	NC_010807.alt2	66.6667	36	45829	45864	29799	29766	24	12
NC_005091.alt1	NC_010807.alt2	72.2222	36	56786	56821	29847	29813	26	10
NC_005091.alt1	NC_010807.alt2	65.7143	35	23471	23505	39533	39557	23	12
NC_005091.alt1	NC_010807.alt2	77.1429	35	33847	33881	26994	27037	27	8
NC_005091.alt1	NC_010807.alt2	62.8571	35	54378	54412	19037	19003	22	13
NC_005091.ref	NC_005091.alt2	95.8963	3972	5370	9341	6048	10019	3809	163
NC_005091.ref	NC_005091.alt2	96.0632	3353	14420	17772	15777	19129	3221	132
NC_005091.ref	NC_005091.alt2	96.0868	3271	40544	43814	44584	47854	3143	128
NC_005091.ref	NC_005091.alt2	96.4497	2197	46921	49117	51559	53755	2119	78
NC_005091.ref	NC_005091.alt2	95.7196	1869	32059	33927	35623	37491	1789	80
NC_005091.ref	NC_005091.alt2	95.8104	1814	11038	12851	12166	13979	1738	76
NC_005091.ref	NC_005091.alt2	96.5498	1768	596	2363	718	2485	1707	61
NC_005091.ref	NC_005091.alt2	96.1823	1755	51369	53123	56580	58334	1688	67
NC_005091.ref	NC_005091.alt2	96.4179	1675	36132	37806	40296	41970	1615	60
NC_005091.ref	NC_005091.alt2	96.9413	1602	43815	45416	47976	49577	1553	49
NC_005091.ref	NC_005091.alt2	95.3033	1533	55923	57455	62164	63696	1461	72
NC_005091.ref	NC_005091.alt2	95.7737	1467	22712	24178	25121	26587	1405	62
NC_005091.ref	NC_005091.alt2	96.2604	1444	54479	55922	60582	62025	1390	54
NC_005091.ref	NC_005091.alt2	95.8815	1384	2850	4233	3251	4634	1327	57
NC_005091.ref	NC_005091.alt2	96.1217	1315	28129	29443	30993	32307	1264	51
NC_005091.ref	NC_005091.alt2	96.3218	1305	39150	40454	43279	44583	1257	48
NC_005091.ref	NC_005091.alt2	96.1656	1304	49480	50783	54399	55702	1254	50
NC_005091.ref	NC_005091.alt2	96.8137	1224	9814	11037	10837	12060	1185	39
NC_005091.ref	NC_005091.alt2	96.2547	1068	26025	27092	28400	29467	1028	40
NC_005091.ref	NC_005091.alt2	96.4321	1009	45628	46636	50061	51069	973	36
NC_005091.ref	NC_005091.alt2	95.5897	975	30374	31348	33690	34664	932	43
NC_005091.ref	NC_005091.alt2	95.7068	955	20112	21066	22587	23541	914	41
NC_005091.ref	NC_005091.alt2	97.3597	909	13511	14419	14701	15609	885	24
NC_005091.ref	NC_005091.alt2	97.1995	857	17773	18629	19437	20293	833	24
NC_005091.ref	NC_005091.alt2	95.8937	828	29546	30373	32717	33544	794	34
NC_005091.ref	NC_005091.alt2	95.6098	820	21246	22065	23540	24359	784	36
NC_005091.ref	NC_005091.alt2	97.1675	812	27317	28128	30035	30846	789	23
NC_005091.ref	NC_005091.alt2	97.4648	710	31349	32058	34769	35478	692	18
NC_005091.ref	NC_005091.alt2	97.6228	631	35501	36131	39541	40171	616	15
NC_005091.ref	NC_005091.alt2	96.4942	599	24742	25340	27500	28098	578	21
NC_005091.ref	NC_005091.alt2	97.4790	595	1	595	1	595	580	15
NC_005091.ref	NC_005091.alt2	95.7045	582	50784	51365	55887	56468	557	25
NC_005091.ref	NC_005091.alt2	98.0357	560	24179	24738	26785	27344	549	11
NC_005091.ref	NC_005091.alt2	97.3881	536	19083	19618	21041	21576	522	14
NC_005091.ref	NC_005091.alt2	98.6220	508	53407	53914	58996	59503	501	7
NC_005091.ref	NC_005091.alt2	93.8272	486	2364	2849	2571	3056	456	30
NC_005091.ref	NC_005091.alt2	96.1864	472	9342	9813	10212	10683	454	18
NC_005091.ref	NC_005091.alt2	95.1271	472	34842	35313	39066	39537	449	23
NC_005091.ref	NC_005091.alt2	96.4680	453	18630	19082	20491	20943	437	16
NC_005091.ref	NC_005091.alt2	95.1501	433	4236	4668	4768	5200	412	21
NC_005091.ref	NC_005091.alt2	96.8370	411	12852	13262	14061	14471	398	13
NC_005091.ref	NC_005091.alt2	98.9924	397	34243	34639	38165	38561	393	4
NC_005091.ref	NC_005091.alt2	98.7310	394	4976	5369	5553	5946	389	5
NC_005091.ref	NC_005091.alt2	99.1713	362	49118	49479	53890	54251	359	3
NC_005091.ref	NC_005091.alt2	98.3333	360	54119	54478	60048	60407	354	6
NC_005091.ref	NC_005091.alt2	95.7655	307	38614	38920	42962	43268	294	13
NC_005091.ref	NC_005091.alt2	95.2542	295	25468	25762	28105	28399	281	14
NC_005091.ref	NC_005091.alt2	98.2877	292	19820	20111	22170	22461	287	5
NC_005091.ref	NC_005091.alt2	95.1724	290	22269	22558	24833	25122	276	14
NC_005091.ref	NC_005091.alt2	97.1831	284	46637	46920	51195	51478	276	8
NC_005091.ref	NC_005091.alt2	95.3571	280	53127	53406	58557	58836	267	13
NC_005091.ref	NC_005091.alt2	98.5348	273	38341	38613	42543	42815	269	4
NC_005091.ref	NC_005091.alt2	97.0037	267	37807	38073	42114	42380	259	8
NC_005091.ref	NC_005091.alt2	1e+02	262	25763	26024	5462	5201	262	0
NC_005091.ref	NC_005091.alt2	98.2533	229	38921	39149	58335	58563	225	4
NC_005091.ref	NC_005091.alt2	1e+02	224	27093	27316	29623	29846	224	0
NC_005091.ref	NC_005091.alt2	97.7169	219	34022	34240	37856	38074	214	5
NC_005091.ref	NC_005091.alt2	1e+02	216	4760	4975	32523	32308	216	0
NC_005091.ref	NC_005091.alt2	1e+02	211	45417	45627	49660	49870	211	0
NC_005091.ref	NC_005091.alt2	99.5050	202	53917	54118	59679	59880	201	1
NC_005091.ref	NC_005091.alt2	1e+02	201	19619	19819	21771	21971	201	0
NC_005091.ref	NC_005091.alt2	95.5	200	22066	22265	24475	24674	191	9
NC_005091.ref	NC_005091.alt2	97.4874	199	34643	34841	38744	38942	194	5
NC_005091.ref	NC_005091.alt2	1e+02	194	38074	38267	3046	3239	194	0
NC_005091.ref	NC_005091.alt2	1e+02	184	35317	35500	55698	55881	184	0
NC_005091.ref	NC_005091.alt2	1e+02	179	21067	21245	37672	37494	179	0
NC_005091.ref	NC_005091.alt2	1e+02	153	22559	22711	24680	24832	153	0
NC_005091.ref	NC_005091.alt2	1e+02	146	13365	13510	33689	33544	146	0
NC_005091.ref	NC_005091.alt2	98.4252	127	25341	25467	47855	47981	125	2
NC_005091.ref	NC_005091.alt2	92.1569	102	13263	13364	14598	14699	94	8
NC_005091.ref	NC_005091.alt2	1e+02	102	29444	29545	32525	32626	102	0
NC_005091.ref	NC_005091.alt2	1e+02	92	33930	34021	37675	37766	92	0
NC_005091.ref	NC_005091.alt2	95.6044	91	4669	4759	5463	5553	87	4
NC_005091.ref	NC_005091.alt2	1e+02	89	40455	40543	42542	42454	89	0
NC_005091.ref	NC_005091.alt2	92.8571	70	38271	38340	42384	42453	65	5
NC_005091.alt1	NC_010807.ref	54.6392	97	20412	20508	2622	2526	53	44
NC_005091.alt1	NC_010807.ref	52.0548	73	9948	10020	37455	37549	38	35
NC_005091.alt1	NC_010807.ref	49.3151	73	47195	47267	24640	24582	36	37
NC_005091.alt1	NC_010807.ref	6e+01	70	151	220	2918	2836	42	28
NC_005091.alt1	NC_010807.ref	52.1739	69	54525	54593	21050	20943	36	33
NC_005091.alt1	NC_010807.ref	48.5294	68	35849	35916	3540	3480	33	35
NC_005091.alt1	NC_010807.ref	56.25	64	7576	7639	14749	14676	36	28
NC_005091.alt1	NC_010807.ref	57.1429	63	44413	44475	22012	21919	36	27
NC_005091.alt1	NC_010807.ref	56.4516	62	22779	22840	35530	35433	35	27
NC_005091.alt1	NC_010807.ref	65.5738	61	37456	37516	14791	14730	40	21
NC_005091.alt1	NC_010807.ref	54.0984	61	38458	38518	30507	30560	33	28
NC_005091.alt1	NC_010807.ref	61.6667	60	46476	46535	25405	25313	37	23
NC_005091.alt1	NC_010807.ref	57.6271	59	26110	26168	20936	20857	34	25
NC_005091.alt1	NC_010807.ref	37.2881	59	52029	52087	24238	24288	22	37
NC_005091.alt1	NC_010807.ref	59.3220	59	57254	57312	37469	37373	35	24
NC_005091.alt1	NC_010807.ref	53.4483	58	47340	47397	26549	26465	31	27
NC_005091.alt1	NC_010807.ref	58.9286	56	1132	1187	6036	5973	33	23
NC_005091.alt1	NC_010807.ref	51.7857	56	7763	7818	2264	2191	29	27
NC_005091.alt1	NC_010807.ref	63.6364	55	31067	31121	14842	14773	35	20
NC_005091.alt1	NC_010807.ref	67.2727	55	46693	46747	21843	21777	37	18
NC_005091.alt1	NC_010807.ref	48.1481	54	33156	33209	8099	8140	26	28
NC_005091.alt1	NC_010807.ref	72.2222	54	38880	38933	30129	30235	39	15
NC_005091.alt1	NC_010807.ref	55.5556	54	54802	54855	10025	10071	30	24
NC_005091.alt1	NC_010807.ref	62.9630	54	56033	56086	12669	12737	34	20
NC_005091.alt1	NC_010807.ref	51.9231	52	1613	1664	24212	24291	27	25
NC_005091.alt1	NC_010807.ref	55.7692	52	4322	4373	10049	10005	29	23
NC_005091.alt1	NC_010807.ref	58.8235	51	21777	21827	11658	11745	30	21
NC_005091.alt1	NC_010807.ref	56.8627	51	55654	55704	31151	31194	29	22
NC_005091.alt1	NC_010807.ref	62	50	47882	47931	28666	28746	31	19
NC_005091.alt1	NC_010807.ref	59.1837	49	5593	5641	26407	26325	29	20
NC_005091.alt1	NC_010807.ref	61.2245	49	8663	8711	32407	32483	30	19
NC_005091.alt1	NC_010807.ref	55.1020	49	46883	46931	4222	4160	27	22
NC_005091.alt1	NC_010807.ref	55.1020	49	51182	51230	29701	29742	27	22
NC_005091.alt1	NC_010807.ref	57.1429	49	53524	53572	23889	23857	28	21
NC_005091.alt1	NC_010807.ref	5e+01	48	49872	49919	18223	18168	24	24
NC_005091.alt1	NC_010807.ref	46.8085	47	55361	55407	25156	25192	22	25
NC_005091.alt1	NC_010807.ref	53.3333	45	10454	10498	3970	3937	24	21
NC_005091.alt1	NC_010807.ref	64.4444	45	27785	27829	26366	26313	29	16
NC_005091.alt1	NC_010807.ref	66.6667	45	53031	53075	34723	34653	30	15
NC_005091.alt1	NC_010807.ref	67.4419	43	8450	8492	27318	27362	29	14
NC_005091.alt1	NC_010807.ref	60.4651	43	15207	15249	7483	7449	26	17
NC_005091.alt1	NC_010807.ref	54.7619	42	21828	21869	2830	2755	23	19
NC_005091.alt1	NC_010807.ref	71.4286	42	25840	25881	20301	20227	30	12
NC_005091.alt1	NC_010807.ref	63.4146	41	21642	21682	1610	1580	26	15
NC_005091.alt1	NC_010807.ref	58.5366	41	26823	26863	24090	24124	24	17
NC_005091.alt1	NC_010807.ref	67.5	40	8332	8371	1993	1954	27	13
NC_005091.alt1	NC_010807.ref	8e+01	40	45763	45802	5611	5580	32	8
NC_005091.alt1	NC_010807.ref	64.1026	39	35786	35824	28790	28822	25	14
NC_005091.alt1	NC_010807.ref	64.1026	39	37039	37077	30058	30027	25	14
NC_005091.alt1	NC_010807.ref	82.0513	39	39548	39586	1177	1137	32	7
NC_005091.alt1	NC_010807.ref	65.7895	38	5376	5413	36744	36772	25	13
NC_005091.alt1	NC_010807.ref	64.8649	37	18066	18102	25574	25503	24	13
NC_005091.alt1	NC_010807.ref	75	36	28108	28143	21723	21668	27	9
NC_005091.alt1	NC_010807.ref	66.6667	36	45829	45864	28766	28733	24	12
NC_005091.alt1	NC_010807.ref	72.2222	36	48852	48887	11459	11411	26	10
NC_005091.alt1	NC_010807.ref	86.1111	36	55122	55157	2101	2070	31	5
NC_005091.alt1	NC_010807.ref	65.7143	35	18621	18655	25954	26020	23	12
NC_005091.alt1	NC_010807.ref	65.7143	35	23471	23505	37793	37817	23	12
NC_005091.alt1	NC_010807.ref	62.8571	35	54378	54412	18093	18059	22	13
NC_005091.alt1	NC_010807.alt3	52.0548	73	9948	10020	38531	38625	38	35
NC_005091.alt1	NC_010807.alt3	47.9452	73	47195	47267	25263	25205	35	38
NC_005091.alt1	NC_010807.alt3	41.1765	68	12006	12073	36183	36128	28	40
NC_005091.alt1	NC_010807.alt3	48.5294	68	35849	35916	4187	4127	33	35
NC_005091.alt1	NC_010807.alt3	56.25	64	7576	7639	14802	14729	36	28
NC_005091.alt1	NC_010807.alt3	57.1429	63	44413	44475	22442	22349	36	27
NC_005091.alt1	NC_010807.alt3	56.4516	62	22779	22840	36116	36019	35	27
NC_005091.alt1	NC_010807.alt3	65.5738	61	37456	37516	14844	14783	40	21
NC_005091.alt1	NC_010807.alt3	54.0984	61	38458	38518	30759	30812	33	28
NC_005091.alt1	NC_010807.alt3	57.6271	59	26110	26168	21257	21178	34	25
NC_005091.alt1	NC_010807.alt3	37.2881	59	52029	52087	24861	24911	22	37
NC_005091.alt1	NC_010807.alt3	59.3220	59	57254	57312	38545	38449	35	24
NC_005091.alt1	NC_010807.alt3	53.4483	58	47340	47397	26688	26604	31	27
NC_005091.alt1	NC_010807.alt3	59.6491	57	20412	20468	3202	3133	34	23
NC_005091.alt1	NC_010807.alt3	58.9286	56	1132	1187	6358	6295	33	23
NC_005091.alt1	NC_010807.alt3	51.7857	56	7763	7818	2682	2609	29	27
NC_005091.alt1	NC_010807.alt3	57.1429	56	17482	17537	1202	1113	32	24
NC_005091.alt1	NC_010807.alt3	5e+01	56	44818	44873	21191	21100	28	28
NC_005091.alt1	NC_010807.alt3	63.6364	55	31067	31121	14895	14826	35	20
NC_005091.alt1	NC_010807.alt3	48.1481	54	33156	33209	8177	8218	26	28
NC_005091.alt1	NC_010807.alt3	74.0741	54	38880	38933	30381	30487	40	14
NC_005091.alt1	NC_010807.alt3	55.5556	54	54802	54855	10241	10287	30	24
NC_005091.alt1	NC_010807.alt3	62.9630	54	56033	56086	12790	12858	34	20
NC_005091.alt1	NC_010807.alt3	51.9231	52	1613	1664	24835	24914	27	25
NC_005091.alt1	NC_010807.alt3	55.7692	52	4322	4373	10265	10221	29	23
NC_005091.alt1	NC_010807.alt3	58.8235	51	21777	21827	11874	11961	30	21
NC_005091.alt1	NC_010807.alt3	54	50	24852	24901	19874	19834	27	23
NC_005091.alt1	NC_010807.alt3	62	50	47882	47931	28643	28723	31	19
NC_005091.alt1	NC_010807.alt3	61.2245	49	8663	8711	32659	32735	30	19
NC_005091.alt1	NC_010807.alt3	55.1020	49	46883	46931	4869	4807	27	22
NC_005091.alt1	NC_010807.alt3	55.1020	49	51182	51230	29953	29994	27	22
NC_005091.alt1	NC_010807.alt3	5e+01	48	49872	49919	18660	18605	24	24
NC_005091.alt1	NC_010807.alt3	46.8085	47	55361	55407	25502	25538	22	25
NC_005091.alt1	NC_010807.alt3	53.3333	45	10454	10498	4617	4584	24	21
NC_005091.alt1	NC_010807.alt3	64.4444	45	27785	27829	34905	34852	29	16
NC_005091.alt1	NC_010807.alt3	66.6667	45	53031	53075	35304	35234	30	15
NC_005091.alt1	NC_010807.alt3	67.4419	43	8450	8492	27457	27501	29	14
NC_005091.alt1	NC_010807.alt3	60.4651	43	15207	15249	36257	36291	26	17
NC_005091.alt1	NC_010807.alt3	55.8140	43	53470	53512	13692	13653	24	19
NC_005091.alt1	NC_010807.alt3	71.4286	42	25840	25881	20622	20548	30	12
NC_005091.alt1	NC_010807.alt3	63.4146	41	21642	21682	2028	1998	26	15
NC_005091.alt1	NC_010807.alt3	58.5366	41	26823	26863	24713	24747	24	17
NC_005091.alt1	NC_010807.alt3	67.5	40	8332	8371	2411	2372	27	13
NC_005091.alt1	NC_010807.alt3	62.5	40	11323	11362	35503	35432	25	15
NC_005091.alt1	NC_010807.alt3	8e+01	40	45763	45802	6048	6017	32	8
NC_005091.alt1	NC_010807.alt3	64.1026	39	35786	35824	28767	28799	25	14
NC_005091.alt1	NC_010807.alt3	64.1026	39	37039	37077	30310	30279	25	14
NC_005091.alt1	NC_010807.alt3	82.0513	39	39548	39586	1595	1555	32	7
NC_005091.alt1	NC_010807.alt3	65.7895	38	5376	5413	37980	38008	25	13
NC_005091.alt1	NC_010807.alt3	64.8649	37	18066	18102	25920	25849	24	13
NC_005091.alt1	NC_010807.alt3	75	36	28108	28143	22044	21989	27	9
NC_005091.alt1	NC_010807.alt3	66.6667	36	45829	45864	28743	28710	24	12
NC_005091.alt1	NC_010807.alt3	72.2222	36	48852	48887	11675	11627	26	10
NC_005091.alt1	NC_010807.alt3	86.1111	36	55122	55157	2519	2488	31	5
NC_005091.alt1	NC_010807.alt3	65.7143	35	18621	18655	26191	26257	23	12
NC_005091.alt1	NC_010807.alt3	65.7143	35	23471	23505	38869	38893	23	12
NC_005091.alt1	NC_010807.alt3	62.8571	35	54378	54412	18530	18496	22	13
NC_005091.ref	NC_025457.ref	52.7027	74	29772	29845	1797	1903	39	35
NC_005091.ref	NC_025457.ref	40.5797	69	47789	47857	359	418	28	41
NC_005091.ref	NC_025457.ref	59.7015	67	37500	37566	23718	23629	40	27
NC_005091.ref	NC_025457.ref	56.4516	62	13479	13540	12371	12319	35	27
NC_005091.ref	NC_025457.ref	52.5424	59	13890	13948	196	268	31	28
NC_005091.ref	NC_025457.ref	40.3509	57	46633	46689	13269	13318	23	34
NC_005091.ref	NC_025457.ref	57.4074	54	763	816	38718	38792	31	23
NC_005091.ref	NC_025457.ref	47.0588	51	54475	54525	41873	41832	24	27
NC_005091.ref	NC_025457.ref	52	50	55046	55095	19324	19366	26	24
NC_005091.ref	NC_025457.ref	57.1429	49	44352	44400	21846	21879	28	21
NC_005091.ref	NC_025457.ref	64.5833	48	18279	18326	17949	17990	31	17
NC_005091.ref	NC_025457.ref	58.3333	48	19114	19161	12425	12342	28	20
NC_005091.ref	NC_025457.ref	57.4468	47	9456	9502	32822	32782	27	20
NC_005091.ref	NC_025457.ref	48.9362	47	32439	32485	40566	40529	23	24
NC_005091.ref	NC_025457.ref	72.3404	47	44846	44892	6499	6568	34	13
NC_005091.ref	NC_025457.ref	65.9091	44	31519	31562	9232	9180	29	15
NC_005091.ref	NC_025457.ref	56.8182	44	33672	33715	27485	27418	25	19
NC_005091.ref	NC_025457.ref	6e+01	40	28561	28600	39585	39618	24	16
NC_005091.ref	NC_025457.ref	56.4103	39	15315	15353	3749	3776	22	17
NC_002486.alt	NC_005091.ref	4e+01	100	2139	2238	20171	20045	40	60
NC_002486.alt	NC_005091.ref	44.6154	65	22227	22291	57177	57120	29	36
NC_002486.alt	NC_005091.ref	48.2759	58	40424	40481	8801	8883	28	30
NC_002486.alt	NC_005091.ref	55.3571	56	18939	18994	28499	28429	31	25
NC_002486.alt	NC_005091.ref	53.7037	54	20897	20950	37719	37668	29	25
NC_002486.alt	NC_005091.ref	56.25	48	45485	45532	56465	56526	27	21
NC_002486.alt	NC_005091.ref	59.5745	47	13601	13647	12812	12731	28	19
NC_002486.alt	NC_005091.ref	43.4783	46	20500	20545	26534	26571	20	26
NC_002486.alt	NC_005091.ref	68.2927	41	19367	19407	4964	4916	28	13
NC_002486.alt	NC_005091.ref	62.5	40	20774	20813	49384	49421	25	15
NC_002486.alt	NC_005091.ref	68.5714	35	812	846	56947	56968	24	11
NC_005091.alt1	NC_025457.alt2	46.3768	69	55809	55877	27238	27181	32	37
NC_005091.alt1	NC_025457.alt2	51.5152	66	12278	12343	7822	7912	34	32
NC_005091.alt1	NC_025457.alt2	53.3333	60	6566	6625	11367	11451	32	28
NC_005091.alt1	NC_025457.alt2	55.1724	58	12551	12608	21647	21601	32	26
NC_005091.alt1	NC_025457.alt2	44.8276	58	15334	15391	37726	37773	26	32
NC_005091.alt1	NC_025457.alt2	56.8966	58	16001	16058	22123	22046	33	25
NC_005091.alt1	NC_025457.alt2	50.8772	57	22888	22944	15087	15001	29	28
NC_005091.alt1	NC_025457.alt2	53.5714	56	18418	18473	57552	57626	30	26
NC_005091.alt1	NC_025457.alt2	42.8571	56	50311	50366	41579	41625	24	32
NC_005091.alt1	NC_025457.alt2	57.1429	56	53507	53562	31137	31054	32	24
NC_005091.alt1	NC_025457.alt2	55.5556	54	47076	47129	60873	60919	30	24
NC_005091.alt1	NC_025457.alt2	54.7170	53	5311	5363	12463	12548	29	24
NC_005091.alt1	NC_025457.alt2	52.8302	53	28992	29044	51557	51513	28	25
NC_005091.alt1	NC_025457.alt2	43.3962	53	40147	40199	4323	4278	23	30
NC_005091.alt1	NC_025457.alt2	65.3846	52	32658	32709	60567	60606	34	18
NC_005091.alt1	NC_025457.alt2	54.9020	51	5129	5179	22860	22911	28	23
NC_005091.alt1	NC_025457.alt2	58	50	3688	3737	42546	42588	29	21
NC_005091.alt1	NC_025457.alt2	64.5833	48	18279	18326	27726	27767	31	17
NC_005091.alt1	NC_025457.alt2	66.6667	48	26945	26992	4319	4354	32	16
NC_005091.alt1	NC_025457.alt2	52.0833	48	28800	28847	34716	34679	25	23
NC_005091.alt1	NC_025457.alt2	53.1915	47	48631	48677	29810	29777	25	22
NC_005091.alt1	NC_025457.alt2	60.8696	46	29145	29190	29057	29125	28	18
NC_005091.alt1	NC_025457.alt2	44.4444	45	10713	10757	60699	60662	20	25
NC_005091.alt1	NC_025457.alt2	53.3333	45	47906	47950	60218	60136	24	21
NC_005091.alt1	NC_025457.alt2	61.3636	44	24200	24243	32692	32656	27	17
NC_005091.alt1	NC_025457.alt2	59.0909	44	52963	53006	49746	49666	26	18
NC_005091.alt1	NC_025457.alt2	70.4545	44	55606	55649	2999	3064	31	13
NC_005091.alt1	NC_025457.alt2	62.7907	43	14472	14514	53771	53739	27	16
NC_005091.alt1	NC_025457.alt2	56.0976	41	14427	14467	19586	19557	23	18
NC_005091.alt1	NC_025457.alt2	66.6667	39	12038	12076	47142	47094	26	13
NC_005091.alt1	NC_025457.alt2	71.7949	39	54831	54869	51634	51704	28	11
NC_005091.ref	NC_025457.alt1	49.0385	104	54245	54348	40691	40785	51	53
NC_005091.ref	NC_025457.alt1	40.5797	69	47789	47857	359	418	28	41
NC_005091.ref	NC_025457.alt1	56.4516	62	13479	13540	11666	11614	35	27
NC_005091.ref	NC_025457.alt1	51.6129	62	19351	19412	39627	39549	32	30
NC_005091.ref	NC_025457.alt1	59.0164	61	47484	47544	9341	9456	36	25
NC_005091.ref	NC_025457.alt1	52.5424	59	13890	13948	196	268	31	28
NC_005091.ref	NC_025457.alt1	56.8966	58	25853	25910	7136	7045	33	25
NC_005091.ref	NC_025457.alt1	40.3509	57	46633	46689	12502	12551	23	34
NC_005091.ref	NC_025457.alt1	55.3571	56	14773	14828	16707	16645	31	25
NC_005091.ref	NC_025457.alt1	55.5556	54	17586	17639	26269	26177	30	24
NC_005091.ref	NC_025457.alt1	56.8627	51	4407	4457	13419	13371	29	22
NC_005091.ref	NC_025457.alt1	67.3469	49	40438	40486	9911	9862	33	16
NC_005091.ref	NC_025457.alt1	64.5833	48	18279	18326	17054	17095	31	17
NC_005091.ref	NC_025457.alt1	57.4468	47	9456	9502	31663	31623	27	20
NC_005091.ref	NC_025457.alt1	48.9362	47	32439	32485	38532	38495	23	24
NC_005091.ref	NC_025457.alt1	54.3478	46	37582	37627	15039	15100	25	21
NC_005091.ref	NC_025457.alt1	62.7907	43	626	668	15061	15134	27	16
NC_005091.ref	NC_025457.alt1	60.9756	41	809	849	38866	38820	25	16
NC_005091.ref	NC_025457.alt1	6e+01	40	28561	28600	37953	37986	24	16
NC_005091.ref	NC_025457.alt1	66.6667	39	49532	49570	26226	26175	26	13
NC_005091.ref	NC_025457.alt1	78.3784	37	20434	20470	18232	18266	29	8
NC_005091.ref	NC_025457.alt1	66.6667	36	31856	31891	30058	30023	24	12
NC_002486.alt	NC_005091.alt1	42.8571	63	32330	32392	44527	44582	27	36
NC_002486.alt	NC_005091.alt1	54.3860	57	27520	27576	7459	7515	31	26
NC_002486.alt	NC_005091.alt1	55.3571	56	18939	18994	28412	28342	31	25
NC_002486.alt	NC_005091.alt1	37.5	56	31506	31561	47328	47281	21	35
NC_002486.alt	NC_005091.alt1	47.2727	55	10373	10427	20206	20163	26	29
NC_002486.alt	NC_005091.alt1	53.7037	54	20897	20950	38025	37974	29	25
NC_002486.alt	NC_005091.alt1	50.9434	53	2139	2191	20171	20082	27	26
NC_002486.alt	NC_005091.alt1	65.3846	52	31880	31931	33470	33533	34	18
NC_002486.alt	NC_005091.alt1	43.4783	46	20500	20545	26447	26484	20	26
NC_002486.alt	NC_005091.alt1	68.2927	41	24019	24059	22800	22755	28	13
NC_002486.alt	NC_005091.alt1	62.5	40	34475	34514	17379	17410	25	15
NC_002486.alt	NC_005091.alt1	69.2308	39	3929	3967	31922	31947	27	12
NC_002486.alt	NC_005091.alt1	69.4444	36	13312	13347	6280	6316	25	11
NC_002486.alt	NC_005091.alt1	68.5714	35	812	846	57023	57002	24	11
NC_005091.ref	NC_002486.alt	46.0938	128	41001	41128	23730	23904	59	69
NC_005091.ref	NC_002486.alt	43.8202	89	2339	2427	23906	23843	39	50
NC_005091.ref	NC_002486.alt	52.9412	68	33156	33223	43024	42949	36	32
NC_005091.ref	NC_002486.alt	52.6316	57	46948	47004	44597	44514	30	27
NC_005091.ref	NC_002486.alt	51.7857	56	42219	42274	41696	41649	29	27
NC_005091.ref	NC_002486.alt	49.0909	55	53408	53462	11168	11226	27	28
NC_005091.ref	NC_002486.alt	59.2593	54	21433	21486	44522	44460	32	22
NC_005091.ref	NC_002486.alt	59.6154	52	28667	28718	30094	30019	31	21
NC_005091.ref	NC_002486.alt	45.8333	48	6931	6978	11729	11798	22	26
NC_005091.ref	NC_002486.alt	55.3191	47	6569	6615	30882	30934	26	21
NC_005091.ref	NC_002486.alt	56.4103	39	45187	45225	22317	22345	22	17
NC_005091.ref	NC_002486.alt	71.7949	39	47243	47281	42963	42894	28	11
NC_005091.ref	NC_002486.alt	63.1579	38	49384	49421	20774	20813	24	14
NC_005091.ref	NC_002486.alt	72.9730	37	25947	25983	6151	6191	27	10
NC_005091.ref	NC_002486.alt	62.1622	37	55028	55064	10183	10154	23	14
NC_005091.ref	NC_002486.ref	46.0938	128	41001	41128	21907	21733	59	69
NC_005091.ref	NC_002486.ref	43.8202	89	2339	2427	21731	21794	39	50
NC_005091.ref	NC_002486.ref	52.9412	68	33156	33223	12600	12525	36	32
NC_005091.ref	NC_002486.ref	52.6316	57	46948	47004	14173	14090	30	27
NC_005091.ref	NC_002486.ref	51.7857	56	42219	42274	11272	11225	29	27
NC_005091.ref	NC_002486.ref	49.0909	55	53408	53462	41592	41650	27	28
NC_005091.ref	NC_002486.ref	59.2593	54	21433	21486	14098	14036	32	22
NC_005091.ref	NC_002486.ref	59.6154	52	28667	28718	15543	15618	31	21
NC_005091.ref	NC_002486.ref	45.8333	48	6931	6978	42153	42222	22	26
NC_005091.ref	NC_002486.ref	55.3191	47	6569	6615	458	510	26	21
NC_005091.ref	NC_002486.ref	56.4103	39	45187	45225	23320	23292	22	17
NC_005091.ref	NC_002486.ref	71.7949	39	47243	47281	12539	12470	28	11
NC_005091.ref	NC_002486.ref	63.1579	38	49384	49421	24863	24824	24	14
NC_005091.ref	NC_002486.ref	72.9730	37	25947	25983	36575	36615	27	10
NC_005091.ref	NC_002486.ref	62.1622	37	55028	55064	40607	40578	23	14
NC_005091.ref	NC_010807.alt1	61.8557	97	20412	20508	2176	2080	60	37
NC_005091.ref	NC_010807.alt1	54.2169	83	45667	45749	28766	28663	45	38
NC_005091.ref	NC_010807.alt1	53.4247	73	9948	10020	37455	37549	39	34
NC_005091.ref	NC_010807.alt1	52.1127	71	49455	49525	12055	11947	37	34
NC_005091.ref	NC_010807.alt1	58.5714	70	151	220	2472	2390	41	29
NC_005091.ref	NC_010807.alt1	52.8571	70	54524	54593	21051	20943	37	33
NC_005091.ref	NC_010807.alt1	59.7015	67	26110	26176	20936	20849	40	27
NC_005091.ref	NC_010807.alt1	65.1515	66	19667	19732	18341	18431	43	23
NC_005091.ref	NC_010807.alt1	46.875	64	42608	42671	6043	6094	30	34
NC_005091.ref	NC_010807.alt1	54.0984	61	38152	38212	30507	30560	33	28
NC_005091.ref	NC_010807.alt1	5e+01	60	52388	52447	10600	10696	30	30
NC_005091.ref	NC_010807.alt1	50.8475	59	32845	32903	7468	7513	30	29
NC_005091.ref	NC_010807.alt1	35.5932	59	51780	51838	24238	24288	21	38
NC_005091.ref	NC_010807.alt1	44.0678	59	57339	57397	37454	37501	26	33
NC_005091.ref	NC_010807.alt1	52.6316	57	15394	15450	7207	7257	30	27
NC_005091.ref	NC_010807.alt1	54.3860	57	30419	30475	28598	28535	31	26
NC_005091.ref	NC_010807.alt1	48.2143	56	54634	54689	18466	18514	27	29
NC_005091.ref	NC_010807.alt1	4e+01	55	24768	24822	25197	25151	22	33
NC_005091.ref	NC_010807.alt1	67.2727	55	46531	46585	21843	21777	37	18
NC_005091.ref	NC_010807.alt1	61.5385	52	3240	3291	29948	29873	32	20
NC_005091.ref	NC_010807.alt1	55.7692	52	4322	4373	9423	9379	29	23
NC_005091.ref	NC_010807.alt1	44.2308	52	33783	33834	12549	12591	23	29
NC_005091.ref	NC_010807.alt1	58.8235	51	23371	23421	14027	13942	30	21
NC_005091.ref	NC_010807.alt1	60.7843	51	47719	47769	28665	28746	31	20
NC_005091.ref	NC_010807.alt1	56.8627	51	55654	55704	31151	31194	29	22
NC_005091.ref	NC_010807.alt1	62	50	56033	56082	12107	12171	31	19
NC_005091.ref	NC_010807.alt1	59.1837	49	5593	5641	26407	26325	29	20
NC_005091.ref	NC_010807.alt1	61.2245	49	14717	14765	788	717	30	19
NC_005091.ref	NC_010807.alt1	61.2245	49	43241	43289	15398	15351	30	19
NC_005091.ref	NC_010807.alt1	53.0612	49	50933	50981	29701	29742	26	23
NC_005091.ref	NC_010807.alt1	48.9796	49	51938	51986	20674	20639	24	25
NC_005091.ref	NC_010807.alt1	5e+01	48	49623	49670	18107	18052	24	24
NC_005091.ref	NC_010807.alt1	53.1915	47	55004	55050	20668	20706	25	22
NC_005091.ref	NC_010807.alt1	52.1739	46	56937	56982	38118	38086	24	22
NC_005091.ref	NC_010807.alt1	48.8889	45	26680	26724	1961	1924	22	23
NC_005091.ref	NC_010807.alt1	62.2222	45	47085	47129	31671	31748	28	17
NC_005091.ref	NC_010807.alt1	56.8182	44	32472	32515	14041	14089	25	19
NC_005091.ref	NC_010807.alt1	70.4545	44	32638	32681	21030	20983	31	13
NC_005091.ref	NC_010807.alt1	60.4651	43	15207	15249	6830	6864	26	17
NC_005091.ref	NC_010807.alt1	67.4419	43	48009	48051	26497	26456	29	14
NC_005091.ref	NC_010807.alt1	61.9048	42	5729	5770	4169	4110	26	16
NC_005091.ref	NC_010807.alt1	71.4286	42	25840	25881	20301	20227	30	12
NC_005091.ref	NC_010807.alt1	66.6667	42	39484	39525	18806	18742	28	14
NC_005091.ref	NC_010807.alt1	63.4146	41	21642	21682	1164	1134	26	15
NC_005091.ref	NC_010807.alt1	58.5366	41	26910	26950	24090	24124	24	17
NC_005091.ref	NC_010807.alt1	65	40	4982	5021	15450	15393	26	14
NC_005091.ref	NC_010807.alt1	67.5	40	8332	8371	1547	1508	27	13
NC_005091.ref	NC_010807.alt1	68.4211	38	16634	16671	37651	37699	26	12
NC_005091.ref	NC_010807.alt1	64.8649	37	18066	18102	25574	25503	24	13
NC_005091.ref	NC_010807.alt1	75	36	28195	28230	21723	21668	27	9
NC_005091.ref	NC_010807.alt1	72.2222	36	50047	50082	32531	32566	26	10
NC_005091.ref	NC_010807.alt1	86.1111	36	55122	55157	1655	1624	31	5
NC_005091.ref	NC_010807.alt1	65.7143	35	23471	23505	37793	37817	23	12
NC_002486.alt	NC_005091.alt2	52.3810	63	5341	5403	38617	38544	33	30
NC_002486.alt	NC_005091.alt2	44.8276	58	22234	22291	63411	63361	26	32
NC_002486.alt	NC_005091.alt2	55.3571	56	18939	18994	31363	31293	31	25
NC_002486.alt	NC_005091.alt2	48.0769	52	14949	15000	53432	53472	25	27
NC_002486.alt	NC_005091.alt2	55.1020	49	16394	16442	33466	33546	27	22
NC_002486.alt	NC_005091.alt2	44.8980	49	18667	18715	14140	14177	22	27
NC_002486.alt	NC_005091.alt2	63.4146	41	17562	17602	63185	63261	26	15
NC_002486.alt	NC_005091.alt2	55	40	19099	19138	48166	48202	22	18
NC_002486.alt	NC_005091.alt2	62.5	40	20774	20813	54156	54193	25	15
NC_002486.alt	NC_005091.alt2	66.6667	36	18162	18197	25276	25217	24	12
NC_002486.alt	NC_005091.alt2	6e+01	35	812	846	63188	63213	21	14
NC_002486.alt	NC_005091.alt2	68.5714	35	19337	19371	28940	28895	24	11
NC_002486.alt	NC_005091.alt2	65.7143	35	41681	41715	61807	61834	23	12
NC_002486.ref	NC_002486.alt	1e+02	15212	1	15212	30425	45636	15212	0
NC_002486.ref	NC_002486.alt	1e+02	15212	15213	30424	30424	15213	15212	0
NC_002486.ref	NC_002486.alt	1e+02	15212	30425	45636	1	15212	15212	0
NC_002486.alt	NC_002486.ref	1e+02	15212	1	15212	30425	45636	15212	0
NC_002486.alt	NC_002486.ref	1e+02	15212	15213	30424	30424	15213	15212	0
NC_002486.alt	NC_002486.ref	1e+02	15212	30425	45636	1	15212	15212	0
NC_005091.ref	NC_010807.alt2	53.9216	102	46785	46886	33628	33465	55	47
NC_005091.ref	NC_010807.alt2	45	100	3104	3203	3816	3724	45	55
NC_005091.ref	NC_010807.alt2	54.2169	83	45667	45749	29799	29696	45	38
NC_005091.ref	NC_010807.alt2	53.4247	73	9948	10020	39195	39289	39	34
NC_005091.ref	NC_010807.alt2	52.1127	71	49455	49525	13313	13205	37	34
NC_005091.ref	NC_010807.alt2	58.5714	70	151	220	3196	3114	41	29
NC_005091.ref	NC_010807.alt2	57.1429	70	20412	20481	2731	2665	40	30
NC_005091.ref	NC_010807.alt2	52.8571	70	54524	54593	21995	21887	37	33
NC_005091.ref	NC_010807.alt2	50.7246	69	44499	44567	17784	17730	35	34
NC_005091.ref	NC_010807.alt2	48.4848	66	10701	10766	25614	25534	32	34
NC_005091.ref	NC_010807.alt2	65.1515	66	19667	19732	19401	19491	43	23
NC_005091.ref	NC_010807.alt2	54.6875	64	30412	30475	29638	29568	35	29
NC_005091.ref	NC_010807.alt2	46.875	64	42608	42671	7255	7306	30	34
NC_005091.ref	NC_010807.alt2	54.0984	61	38152	38212	31818	31871	33	28
NC_005091.ref	NC_010807.alt2	5e+01	60	52388	52447	12038	12134	30	30
NC_005091.ref	NC_010807.alt2	35.5932	59	51780	51838	25271	25321	21	38
NC_005091.ref	NC_010807.alt2	44.0678	59	57339	57397	39194	39241	26	33
NC_005091.ref	NC_010807.alt2	50.8772	57	15394	15450	8419	8469	29	28
NC_005091.ref	NC_010807.alt2	61.5385	52	3240	3291	31259	31184	32	20
NC_005091.ref	NC_010807.alt2	55.7692	52	4322	4373	10745	10701	29	23
NC_005091.ref	NC_010807.alt2	46.1538	52	55442	55493	16766	16728	24	28
NC_005091.ref	NC_010807.alt2	58.8235	51	23371	23421	15378	15293	30	21
NC_005091.ref	NC_010807.alt2	54.9020	51	45409	45459	18565	18503	28	23
NC_005091.ref	NC_010807.alt2	60.7843	51	47719	47769	29698	29779	31	20
NC_005091.ref	NC_010807.alt2	58.8235	51	55654	55704	32462	32505	30	21
NC_005091.ref	NC_010807.alt2	62	50	56033	56082	13365	13429	31	19
NC_005091.ref	NC_010807.alt2	59.1837	49	5593	5641	27440	27358	29	20
NC_005091.ref	NC_010807.alt2	61.2245	49	8663	8711	33718	33794	30	19
NC_005091.ref	NC_010807.alt2	73.4694	49	17538	17586	2923	2979	36	13
NC_005091.ref	NC_010807.alt2	61.2245	49	43241	43289	16465	16418	30	19
NC_005091.ref	NC_010807.alt2	48.9796	49	51938	51986	21618	21583	24	25
NC_005091.ref	NC_010807.alt2	5e+01	48	49623	49670	19167	19112	24	24
NC_005091.ref	NC_010807.alt2	59.5745	47	13869	13915	15402	15461	28	19
NC_005091.ref	NC_010807.alt2	53.1915	47	21271	21317	6271	6323	25	22
NC_005091.ref	NC_010807.alt2	53.1915	47	55004	55050	21612	21650	25	22
NC_005091.ref	NC_010807.alt2	52.1739	46	56937	56982	39858	39826	24	22
NC_005091.ref	NC_010807.alt2	62.2222	45	47085	47129	32982	33059	28	17
NC_005091.ref	NC_010807.alt2	66.6667	45	52782	52826	36290	36220	30	15
NC_005091.ref	NC_010807.alt2	70.4545	44	32638	32681	21974	21927	31	13
NC_005091.ref	NC_010807.alt2	60.4651	43	15207	15249	8069	8035	26	17
NC_005091.ref	NC_010807.alt2	67.4419	43	48009	48051	27530	27489	29	14
NC_005091.ref	NC_010807.alt2	61.9048	42	5729	5770	5073	5014	26	16
NC_005091.ref	NC_010807.alt2	71.4286	42	25840	25881	21245	21171	30	12
NC_005091.ref	NC_010807.alt2	69.0476	42	50907	50948	21824	21859	29	13
NC_005091.ref	NC_010807.alt2	63.4146	41	21642	21682	1719	1689	26	15
NC_005091.ref	NC_010807.alt2	58.5366	41	26910	26950	25123	25157	24	17
NC_005091.ref	NC_010807.alt2	65	40	4982	5021	16517	16460	26	14
NC_005091.ref	NC_010807.alt2	6e+01	40	26137	26176	22737	22705	24	16
NC_005091.ref	NC_010807.alt2	65	40	32752	32791	24352	24301	26	14
NC_005091.ref	NC_010807.alt2	8e+01	40	45601	45640	5889	5858	32	8
NC_005091.ref	NC_010807.alt2	68.4211	38	16634	16671	39391	39439	26	12
NC_005091.ref	NC_010807.alt2	64.8649	37	18066	18102	26607	26536	24	13
NC_005091.ref	NC_010807.alt2	67.5676	37	32066	32102	29441	29405	25	12
NC_005091.ref	NC_010807.alt2	69.4444	36	12369	12404	11068	11131	25	11
NC_005091.ref	NC_010807.alt2	72.2222	36	28195	28230	22667	22612	26	10
NC_005091.ref	NC_010807.alt2	72.2222	36	56786	56821	29847	29813	26	10
NC_005091.ref	NC_010807.alt2	65.7143	35	23471	23505	39533	39557	23	12
NC_005091.ref	NC_010807.ref	54.2169	83	45667	45749	28766	28663	45	38
NC_005091.ref	NC_010807.ref	53.4247	73	9948	10020	37455	37549	39	34
NC_005091.ref	NC_010807.ref	52.1127	71	49455	49525	12617	12509	37	34
NC_005091.ref	NC_010807.ref	58.5714	70	151	220	2918	2836	41	29
NC_005091.ref	NC_010807.ref	57.1429	70	20412	20481	2622	2556	40	30
NC_005091.ref	NC_010807.ref	52.8571	70	54524	54593	21051	20943	37	33
NC_005091.ref	NC_010807.ref	59.7015	67	26110	26176	20936	20849	40	27
NC_005091.ref	NC_010807.ref	65.1515	66	19667	19732	18457	18547	43	23
NC_005091.ref	NC_010807.ref	54.6875	64	30412	30475	28605	28535	35	29
NC_005091.ref	NC_010807.ref	46.875	64	42608	42671	6669	6720	30	34
NC_005091.ref	NC_010807.ref	54.0984	61	38152	38212	30507	30560	33	28
NC_005091.ref	NC_010807.ref	5e+01	60	52388	52447	11342	11438	30	30
NC_005091.ref	NC_010807.ref	50.8475	59	32845	32903	8094	8139	30	29
NC_005091.ref	NC_010807.ref	35.5932	59	51780	51838	24238	24288	21	38
NC_005091.ref	NC_010807.ref	44.0678	59	57339	57397	37454	37501	26	33
NC_005091.ref	NC_010807.ref	50.8772	57	15394	15450	7833	7883	29	28
NC_005091.ref	NC_010807.ref	48.2143	56	54634	54689	18582	18630	27	29
NC_005091.ref	NC_010807.ref	4e+01	55	24768	24822	25197	25151	22	33
NC_005091.ref	NC_010807.ref	67.2727	55	46531	46585	21843	21777	37	18
NC_005091.ref	NC_010807.ref	61.5385	52	3240	3291	29948	29873	32	20
NC_005091.ref	NC_010807.ref	55.7692	52	4322	4373	10049	10005	29	23
NC_005091.ref	NC_010807.ref	58.8235	51	23371	23421	14589	14504	30	21
NC_005091.ref	NC_010807.ref	60.7843	51	47719	47769	28665	28746	31	20
NC_005091.ref	NC_010807.ref	56.8627	51	55654	55704	31151	31194	29	22
NC_005091.ref	NC_010807.ref	62	50	56033	56082	12669	12733	31	19
NC_005091.ref	NC_010807.ref	59.1837	49	5593	5641	26407	26325	29	20
NC_005091.ref	NC_010807.ref	61.2245	49	8663	8711	32407	32483	30	19
NC_005091.ref	NC_010807.ref	61.2245	49	14717	14765	1234	1163	30	19
NC_005091.ref	NC_010807.ref	61.2245	49	43241	43289	15676	15629	30	19
NC_005091.ref	NC_010807.ref	53.0612	49	50933	50981	29701	29742	26	23
NC_005091.ref	NC_010807.ref	48.9796	49	51938	51986	20674	20639	24	25
NC_005091.ref	NC_010807.ref	5e+01	48	49623	49670	18223	18168	24	24
NC_005091.ref	NC_010807.ref	53.1915	47	55004	55050	20668	20706	25	22
NC_005091.ref	NC_010807.ref	52.1739	46	56937	56982	38118	38086	24	22
NC_005091.ref	NC_010807.ref	62.2222	45	47085	47129	31671	31748	28	17
NC_005091.ref	NC_010807.ref	66.6667	45	52782	52826	34723	34653	30	15
NC_005091.ref	NC_010807.ref	70.4545	44	32638	32681	21030	20983	31	13
NC_005091.ref	NC_010807.ref	60.4651	43	15207	15249	7483	7449	26	17
NC_005091.ref	NC_010807.ref	72.0930	43	33550	33592	27217	27173	31	12
NC_005091.ref	NC_010807.ref	67.4419	43	48009	48051	26497	26456	29	14
NC_005091.ref	NC_010807.ref	61.9048	42	5729	5770	4795	4736	26	16
NC_005091.ref	NC_010807.ref	71.4286	42	25840	25881	20301	20227	30	12
NC_005091.ref	NC_010807.ref	66.6667	42	39484	39525	18922	18858	28	14
NC_005091.ref	NC_010807.ref	63.4146	41	21642	21682	1610	1580	26	15
NC_005091.ref	NC_010807.ref	58.5366	41	26910	26950	24090	24124	24	17
NC_005091.ref	NC_010807.ref	65	40	4982	5021	15728	15671	26	14
NC_005091.ref	NC_010807.ref	67.5	40	8332	8371	1993	1954	27	13
NC_005091.ref	NC_010807.ref	8e+01	40	45601	45640	5611	5580	32	8
NC_005091.ref	NC_010807.ref	68.4211	38	16634	16671	37651	37699	26	12
NC_005091.ref	NC_010807.ref	64.8649	37	18066	18102	25574	25503	24	13
NC_005091.ref	NC_010807.ref	69.4444	36	12369	12404	10372	10435	25	11
NC_005091.ref	NC_010807.ref	75	36	28195	28230	21723	21668	27	9
NC_005091.ref	NC_010807.ref	69.4444	36	50047	50082	32531	32566	25	11
NC_005091.ref	NC_010807.ref	86.1111	36	55122	55157	2101	2070	31	5
NC_005091.ref	NC_010807.ref	65.7143	35	23471	23505	37793	37817	23	12
NC_002486.ref	NC_005091.ref	4e+01	100	32563	32662	20171	20045	40	60
NC_002486.ref	NC_005091.ref	42.8571	77	19734	19810	46931	47030	33	44
NC_002486.ref	NC_005091.ref	48.2759	58	10000	10057	8801	8883	28	30
NC_002486.ref	NC_005091.ref	56.25	48	15061	15108	56465	56526	27	21
NC_002486.ref	NC_005091.ref	61.7021	47	26040	26086	36786	36863	29	18
NC_002486.ref	NC_005091.ref	59.5745	47	44025	44071	12812	12731	28	19
NC_002486.ref	NC_005091.ref	54.7619	42	27265	27306	50093	50059	23	19
NC_002486.ref	NC_005091.ref	68.5714	35	31236	31270	56947	56968	24	11
NC_005091.ref	NC_010807.alt3	54.2169	83	45667	45749	28743	28640	45	38
NC_005091.ref	NC_010807.alt3	53.4247	73	9948	10020	38531	38625	39	34
NC_005091.ref	NC_010807.alt3	41.1765	68	12006	12073	36183	36128	28	40
NC_005091.ref	NC_010807.alt3	59.7015	67	26110	26176	21257	21170	40	27
NC_005091.ref	NC_010807.alt3	65.1515	66	19667	19732	19104	19194	43	23
NC_005091.ref	NC_010807.alt3	54.6875	64	30412	30475	28582	28512	35	29
NC_005091.ref	NC_010807.alt3	46.875	64	42608	42671	6853	6904	30	34
NC_005091.ref	NC_010807.alt3	46.875	64	53455	53518	33050	33132	30	34
NC_005091.ref	NC_010807.alt3	54.0984	61	38152	38212	30759	30812	33	28
NC_005091.ref	NC_010807.alt3	5e+01	60	52388	52447	11558	11654	30	30
NC_005091.ref	NC_010807.alt3	50.8475	59	32845	32903	8172	8217	30	29
NC_005091.ref	NC_010807.alt3	35.5932	59	51780	51838	24861	24911	21	38
NC_005091.ref	NC_010807.alt3	44.0678	59	57339	57397	38530	38577	26	33
NC_005091.ref	NC_010807.alt3	50.8772	57	15394	15450	7911	7961	29	28
NC_005091.ref	NC_010807.alt3	63.1579	57	20412	20468	3202	3133	36	21
NC_005091.ref	NC_010807.alt3	58.9286	56	17482	17537	1202	1113	33	23
NC_005091.ref	NC_010807.alt3	48.2143	56	54634	54689	19229	19277	27	29
NC_005091.ref	NC_010807.alt3	4e+01	55	24768	24822	25543	25497	22	33
NC_005091.ref	NC_010807.alt3	59.2593	54	20577	20630	22828	22746	32	22
NC_005091.ref	NC_010807.alt3	60.3774	53	13738	13790	3315	3400	32	21
NC_005091.ref	NC_010807.alt3	61.5385	52	3240	3291	30200	30125	32	20
NC_005091.ref	NC_010807.alt3	55.7692	52	4322	4373	10265	10221	29	23
NC_005091.ref	NC_010807.alt3	58.8235	51	23371	23421	14642	14557	30	21
NC_005091.ref	NC_010807.alt3	60.7843	51	47719	47769	28642	28723	31	20
NC_005091.ref	NC_010807.alt3	62	50	56033	56082	12790	12854	31	19
NC_005091.ref	NC_010807.alt3	61.2245	49	8663	8711	32659	32735	30	19
NC_005091.ref	NC_010807.alt3	61.2245	49	14717	14765	1652	1581	30	19
NC_005091.ref	NC_010807.alt3	61.2245	49	43241	43289	15929	15882	30	19
NC_005091.ref	NC_010807.alt3	53.0612	49	50933	50981	29953	29994	26	23
NC_005091.ref	NC_010807.alt3	48.9796	49	51938	51986	20995	20960	24	25
NC_005091.ref	NC_010807.alt3	5e+01	48	49623	49670	18660	18605	24	24
NC_005091.ref	NC_010807.alt3	53.1915	47	55004	55050	20989	21027	25	22
NC_005091.ref	NC_010807.alt3	52.1739	46	56937	56982	39194	39162	24	22
NC_005091.ref	NC_010807.alt3	62.2222	45	47085	47129	31923	32000	28	17
NC_005091.ref	NC_010807.alt3	66.6667	45	52782	52826	35304	35234	30	15
NC_005091.ref	NC_010807.alt3	68.1818	44	8121	8164	37740	37816	30	14
NC_005091.ref	NC_010807.alt3	70.4545	44	32638	32681	21351	21304	31	13
NC_005091.ref	NC_010807.alt3	60.4651	43	15207	15249	36257	36291	26	17
NC_005091.ref	NC_010807.alt3	72.0930	43	33550	33592	27356	27312	31	12
NC_005091.ref	NC_010807.alt3	67.4419	43	48009	48051	26636	26595	29	14
NC_005091.ref	NC_010807.alt3	55.8140	43	53221	53263	13692	13653	24	19
NC_005091.ref	NC_010807.alt3	61.9048	42	5729	5770	5232	5173	26	16
NC_005091.ref	NC_010807.alt3	71.4286	42	25840	25881	20622	20548	30	12
NC_005091.ref	NC_010807.alt3	66.6667	42	39484	39525	19569	19505	28	14
NC_005091.ref	NC_010807.alt3	63.4146	41	21642	21682	2028	1998	26	15
NC_005091.ref	NC_010807.alt3	58.5366	41	26910	26950	24713	24747	24	17
NC_005091.ref	NC_010807.alt3	65	40	4982	5021	15981	15924	26	14
NC_005091.ref	NC_010807.alt3	67.5	40	8332	8371	2411	2372	27	13
NC_005091.ref	NC_010807.alt3	8e+01	40	45601	45640	6048	6017	32	8
NC_005091.ref	NC_010807.alt3	61.5385	39	39436	39474	34831	34786	24	15
NC_005091.ref	NC_010807.alt3	64.8649	37	18066	18102	25920	25849	24	13
NC_005091.ref	NC_010807.alt3	69.4444	36	12369	12404	10588	10651	25	11
NC_005091.ref	NC_010807.alt3	75	36	28195	28230	22044	21989	27	9
NC_005091.ref	NC_010807.alt3	69.4444	36	50047	50082	32783	32818	25	11
NC_005091.ref	NC_010807.alt3	86.1111	36	55122	55157	2519	2488	31	5
NC_005091.ref	NC_010807.alt3	65.7143	35	23471	23505	38869	38893	23	12
NC_002486.alt	NC_025457.ref	42.0455	88	41221	41308	3947	3832	37	51
NC_002486.alt	NC_025457.ref	49.4253	87	16857	16943	17195	17113	43	44
NC_002486.alt	NC_025457.ref	61.1111	72	19911	19982	24243	24364	44	28
NC_002486.alt	NC_025457.ref	5e+01	72	45497	45568	17222	17281	36	36
NC_002486.alt	NC_025457.ref	52.1739	69	27889	27957	12608	12713	36	33
NC_002486.alt	NC_025457.ref	47.7612	67	20347	20413	12005	12064	32	35
NC_002486.alt	NC_025457.ref	39.3939	66	8072	8137	5041	5096	26	40
NC_002486.alt	NC_025457.ref	52.3077	65	39142	39206	2070	2135	34	31
NC_002486.alt	NC_025457.ref	56.9231	65	44814	44878	26527	26439	37	28
NC_002486.alt	NC_025457.ref	44.2623	61	29412	29472	4741	4792	27	34
NC_002486.alt	NC_025457.ref	6e+01	60	40794	40853	8030	8082	36	24
NC_002486.alt	NC_025457.ref	56.6667	60	41006	41065	15409	15459	34	26
NC_002486.alt	NC_025457.ref	43.1034	58	4714	4771	30658	30706	25	33
NC_002486.alt	NC_025457.ref	58.6207	58	6444	6501	35209	35254	34	24
NC_002486.alt	NC_025457.ref	64.9123	57	15630	15686	30932	31050	37	20
NC_002486.alt	NC_025457.ref	57.1429	56	7618	7673	506	584	32	24
NC_002486.alt	NC_025457.ref	55.3571	56	19515	19570	32070	31979	31	25
NC_002486.alt	NC_025457.ref	54.5455	55	4189	4243	26066	26019	30	25
NC_002486.alt	NC_025457.ref	52.7273	55	9752	9806	1377	1336	29	26
NC_002486.alt	NC_025457.ref	65.4545	55	22663	22717	493	426	36	19
NC_002486.alt	NC_025457.ref	56.3636	55	27724	27778	35216	35168	31	24
NC_002486.alt	NC_025457.ref	52.7273	55	37957	38011	33259	33323	29	26
NC_002486.alt	NC_025457.ref	50.9091	55	43098	43152	16795	16748	28	27
NC_002486.alt	NC_025457.ref	62.2642	53	44430	44482	28902	28849	33	20
NC_002486.alt	NC_025457.ref	59.6154	52	40615	40666	18888	18956	31	21
NC_002486.alt	NC_025457.ref	56.8627	51	37091	37141	40484	40538	29	22
NC_002486.alt	NC_025457.ref	57.1429	49	23796	23844	1624	1583	28	21
NC_002486.alt	NC_025457.ref	60.4167	48	17383	17430	23213	23132	29	19
NC_002486.alt	NC_025457.ref	59.5745	47	20607	20653	32655	32690	28	19
NC_002486.alt	NC_025457.ref	44.6809	47	30085	30131	29073	29111	21	26
NC_002486.alt	NC_025457.ref	84.7826	46	26467	26512	23333	23422	39	7
NC_002486.alt	NC_025457.ref	58.6957	46	40077	40122	11140	11183	27	19
NC_002486.alt	NC_025457.ref	71.7391	46	41697	41742	24789	24744	33	13
NC_002486.alt	NC_025457.ref	55.5556	45	28600	28644	25257	25183	25	20
NC_002486.alt	NC_025457.ref	65.9091	44	3783	3826	8579	8623	29	15
NC_002486.alt	NC_025457.ref	61.3636	44	5047	5090	29812	29780	27	17
NC_002486.alt	NC_025457.ref	60.4651	43	40493	40535	2163	2118	26	17
NC_002486.alt	NC_025457.ref	54.7619	42	30418	30459	40495	40466	23	19
NC_002486.alt	NC_025457.ref	71.4286	42	33191	33232	15892	15851	30	12
NC_002486.alt	NC_025457.ref	64.2857	42	40710	40751	4098	4162	27	15
NC_002486.alt	NC_025457.ref	65.8537	41	15766	15806	22352	22312	27	14
NC_002486.alt	NC_025457.ref	51.2195	41	37147	37187	15865	15897	21	20
NC_002486.alt	NC_025457.ref	67.5	40	18582	18621	2201	2235	27	13
NC_002486.alt	NC_025457.ref	77.5	40	39474	39513	14835	14876	31	9
NC_002486.alt	NC_025457.ref	61.5385	39	3179	3217	11138	11177	24	15
NC_002486.alt	NC_025457.ref	76.9231	39	7377	7415	24724	24777	30	9
NC_002486.alt	NC_025457.ref	57.8947	38	5629	5666	36371	36400	22	16
NC_002486.alt	NC_025457.ref	71.0526	38	27331	27368	12020	11985	27	11
NC_002486.alt	NC_025457.ref	84.2105	38	31473	31510	39240	39133	32	6
NC_002486.alt	NC_025457.ref	64.8649	37	11864	11900	42231	42198	24	13
NC_002486.alt	NC_025457.ref	75.6757	37	24096	24132	28002	28044	28	9
NC_002486.alt	NC_025457.ref	61.1111	36	38182	38217	17814	17853	22	14
NC_002486.alt	NC_025457.ref	68.5714	35	32071	32105	19826	19860	24	11
NC_002486.ref	NC_005091.alt1	54.4304	79	27265	27343	50342	50224	43	36
NC_002486.ref	NC_005091.alt1	42.8571	77	19734	19810	47093	47192	33	44
NC_002486.ref	NC_005091.alt1	42.8571	63	1906	1968	44527	44582	27	36
NC_002486.ref	NC_005091.alt1	37.5	56	1082	1137	47328	47281	21	35
NC_002486.ref	NC_005091.alt1	47.2727	55	40797	40851	20206	20163	26	29
NC_002486.ref	NC_005091.alt1	50.9434	53	32563	32615	20171	20082	27	26
NC_002486.ref	NC_005091.alt1	65.3846	52	1456	1507	33470	33533	34	18
NC_002486.ref	NC_005091.alt1	6e+01	50	22899	22948	57126	57172	30	20
NC_002486.ref	NC_005091.alt1	63.4146	41	17900	17940	50023	49948	26	15
NC_002486.ref	NC_005091.alt1	62.5	40	4051	4090	17379	17410	25	15
NC_002486.ref	NC_005091.alt1	6e+01	40	16928	16967	31288	31334	24	16
NC_002486.ref	NC_005091.alt1	69.2308	39	34353	34391	31922	31947	27	12
NC_002486.ref	NC_005091.alt1	69.4444	36	43736	43771	6280	6316	25	11
NC_002486.ref	NC_005091.alt1	68.5714	35	31236	31270	57023	57002	24	11
NC_002486.alt	NC_010807.alt1	54.3478	92	39146	39237	28243	28370	50	42
NC_002486.alt	NC_010807.alt1	48.8095	84	4791	4874	16049	16112	41	43
NC_002486.alt	NC_010807.alt1	43.5897	78	5341	5418	18328	18393	34	44
NC_002486.alt	NC_010807.alt1	54.1667	72	36538	36609	38198	38133	39	33
NC_002486.alt	NC_010807.alt1	55.8824	68	8926	8993	28691	28770	38	30
NC_002486.alt	NC_010807.alt1	52.3077	65	36838	36902	34843	34900	34	31
NC_002486.alt	NC_010807.alt1	54.6875	64	24205	24268	22840	22752	35	29
NC_002486.alt	NC_010807.alt1	58.7302	63	10715	10777	21473	21567	37	26
NC_002486.alt	NC_010807.alt1	55.7377	61	36408	36468	37512	37437	34	27
NC_002486.alt	NC_010807.alt1	49.1525	59	33557	33615	14975	14924	29	30
NC_002486.alt	NC_010807.alt1	51.7857	56	19855	19910	30280	30235	29	27
NC_002486.alt	NC_010807.alt1	55.3571	56	31452	31507	18578	18511	31	25
NC_002486.alt	NC_010807.alt1	57.1429	56	35030	35085	10161	10262	32	24
NC_002486.alt	NC_010807.alt1	53.8462	52	7721	7772	27802	27844	28	24
NC_002486.alt	NC_010807.alt1	51.9231	52	17441	17492	34294	34209	27	25
NC_002486.alt	NC_010807.alt1	52	50	25395	25444	38379	38339	26	24
NC_002486.alt	NC_010807.alt1	57.1429	49	8157	8205	33115	33159	28	21
NC_002486.alt	NC_010807.alt1	58.3333	48	4609	4656	15098	15064	28	20
NC_002486.alt	NC_010807.alt1	58.3333	48	40930	40977	23450	23488	28	20
NC_002486.alt	NC_010807.alt1	67.3913	46	1446	1491	17705	17624	31	15
NC_002486.alt	NC_010807.alt1	65.9091	44	38796	38839	4604	4537	29	15
NC_002486.alt	NC_010807.alt1	70.7317	41	28491	28531	10126	10190	29	12
NC_002486.alt	NC_010807.alt1	61.5385	39	29465	29503	17287	17219	24	15
NC_002486.alt	NC_010807.alt1	71.0526	38	29989	30026	36448	36515	27	11
NC_002486.alt	NC_010807.alt1	55.2632	38	39502	39539	24901	24940	21	17
NC_002486.alt	NC_010807.alt1	72.9730	37	43788	43824	25427	25480	27	10
NC_002486.alt	NC_010807.alt1	65.7143	35	21500	21534	33596	33571	23	12
NC_002486.ref	NC_005091.alt2	54.6667	75	23631	23705	56957	56888	41	34
NC_002486.ref	NC_005091.alt2	52.3810	63	35765	35827	38617	38544	33	30
NC_002486.ref	NC_005091.alt2	48.0769	52	45373	45424	53432	53472	25	27
NC_002486.ref	NC_005091.alt2	61.7021	47	26040	26086	40950	41027	29	18
NC_002486.ref	NC_005091.alt2	83.7209	43	26763	26805	17269	17358	36	7
NC_002486.ref	NC_005091.alt2	64.8649	37	23708	23744	28724	28767	24	13
NC_002486.ref	NC_005091.alt2	75	36	28233	28268	22334	22266	27	9
NC_002486.ref	NC_005091.alt2	65.7143	35	11257	11291	61807	61834	23	12
NC_002486.ref	NC_005091.alt2	6e+01	35	31236	31270	63188	63213	21	14
NC_025457.ref	NC_002486.alt	46.6667	90	23333	23422	26467	26539	42	48
NC_025457.ref	NC_002486.alt	54.1176	85	39143	39227	13110	12993	46	39
NC_025457.ref	NC_002486.alt	55.8824	68	28977	29044	37890	37969	38	30
NC_025457.ref	NC_002486.alt	60.2941	68	36528	36595	16275	16372	41	27
NC_025457.ref	NC_002486.alt	60.9375	64	5319	5382	28955	29081	39	25
NC_025457.ref	NC_002486.alt	63.7931	58	34578	34635	27842	27762	37	21
NC_025457.ref	NC_002486.alt	57.8947	57	32507	32563	40688	40619	33	24
NC_025457.ref	NC_002486.alt	58.9286	56	5724	5779	33971	33908	33	23
NC_025457.ref	NC_002486.alt	58.9286	56	17222	17277	45497	45568	33	23
NC_025457.ref	NC_002486.alt	66.6667	54	10530	10583	937	1028	36	18
NC_025457.ref	NC_002486.alt	57.6923	52	15742	15793	32623	32535	30	22
NC_025457.ref	NC_002486.alt	65.3846	52	18522	18573	19218	19128	34	18
NC_025457.ref	NC_002486.alt	56.8627	51	24068	24118	13012	12966	29	22
NC_025457.ref	NC_002486.alt	37.2549	51	35206	35256	27734	27691	19	32
NC_025457.ref	NC_002486.alt	54	50	24859	24908	7747	7705	27	23
NC_025457.ref	NC_002486.alt	64	50	38201	38250	32133	32048	32	18
NC_025457.ref	NC_002486.alt	69.3878	49	1879	1927	4343	4397	34	15
NC_025457.ref	NC_002486.alt	59.1837	49	7397	7445	6502	6565	29	20
NC_025457.ref	NC_002486.alt	61.2245	49	13344	13392	40142	40072	30	19
NC_025457.ref	NC_002486.alt	59.1837	49	16816	16864	829	895	29	20
NC_025457.ref	NC_002486.alt	61.2245	49	18123	18171	25452	25374	30	19
NC_025457.ref	NC_002486.alt	5e+01	48	1968	2015	38189	38229	24	24
NC_025457.ref	NC_002486.alt	64.5833	48	27272	27319	23728	23673	31	17
NC_025457.ref	NC_002486.alt	61.7021	47	13440	13486	44151	44217	29	18
NC_025457.ref	NC_002486.alt	59.0909	44	4333	4376	25514	25570	26	18
NC_025457.ref	NC_002486.alt	56.8182	44	41752	41795	41540	41618	25	19
NC_025457.ref	NC_002486.alt	62.7907	43	10406	10448	12946	12894	27	16
NC_025457.ref	NC_002486.alt	62.7907	43	24400	24442	2082	2048	27	16
NC_025457.ref	NC_002486.alt	64.2857	42	8159	8200	26426	26371	27	15
NC_025457.ref	NC_002486.alt	57.1429	42	22717	22758	33349	33281	24	18
NC_025457.ref	NC_002486.alt	70.7317	41	11212	11252	20597	20532	29	12
NC_025457.ref	NC_002486.alt	53.6585	41	28288	28328	12176	12234	22	19
NC_025457.ref	NC_002486.alt	57.5	40	11138	11177	3179	3217	23	17
NC_025457.ref	NC_002486.alt	60.5263	38	20795	20832	4529	4467	23	15
NC_025457.ref	NC_002486.alt	65.7895	38	34118	34155	39222	39146	25	13
NC_025457.ref	NC_002486.alt	78.3784	37	4098	4134	40710	40782	29	8
NC_025457.ref	NC_002486.alt	59.4595	37	30658	30694	4714	4771	22	15
NC_025457.ref	NC_002486.alt	72.2222	36	15284	15319	41553	41627	26	10
NC_025457.ref	NC_002486.alt	66.6667	36	29741	29776	32432	32497	24	12
NC_025457.ref	NC_002486.alt	69.4444	36	32655	32690	20607	20653	25	11
NC_025457.ref	NC_002486.alt	62.8571	35	2201	2235	18582	18621	22	13
NC_025457.ref	NC_002486.alt	71.4286	35	30125	30159	25256	25329	25	10
NC_005091.ref	NC_025457.alt2	55.5556	72	33305	33376	26975	27082	40	32
NC_005091.ref	NC_025457.alt2	50.7692	65	4265	4329	13743	13663	33	32
NC_005091.ref	NC_025457.alt2	56.25	64	50957	51020	1569	1641	36	28
NC_005091.ref	NC_025457.alt2	49.2063	63	21488	21550	22637	22567	31	32
NC_005091.ref	NC_025457.alt2	53.4483	58	12551	12608	21647	21600	31	27
NC_005091.ref	NC_025457.alt2	48.2759	58	15334	15391	37726	37773	28	30
NC_005091.ref	NC_025457.alt2	47.3684	57	1208	1264	8520	8471	27	30
NC_005091.ref	NC_025457.alt2	52.6316	57	8431	8487	16630	16581	30	27
NC_005091.ref	NC_025457.alt2	56.1404	57	35366	35422	49121	49195	32	25
NC_005091.ref	NC_025457.alt2	44.6429	56	55409	55464	18976	19037	25	31
NC_005091.ref	NC_025457.alt2	57.6923	52	19911	19962	11658	11713	30	22
NC_005091.ref	NC_025457.alt2	58	50	3688	3737	42546	42588	29	21
NC_005091.ref	NC_025457.alt2	4e+01	50	6580	6629	26653	26611	20	30
NC_005091.ref	NC_025457.alt2	64.5833	48	18279	18326	27726	27767	31	17
NC_005091.ref	NC_025457.alt2	54.1667	48	18533	18580	4204	4281	26	22
NC_005091.ref	NC_025457.alt2	56.25	48	22848	22895	63261	63188	27	21
NC_005091.ref	NC_025457.alt2	68.0851	47	29226	29272	35995	36067	32	15
NC_005091.ref	NC_025457.alt2	48.9362	47	32439	32485	60577	60540	23	24
NC_005091.ref	NC_025457.alt2	63.8298	47	34594	34640	6864	6944	30	17
NC_005091.ref	NC_025457.alt2	48.9362	47	57010	57056	24542	24507	23	24
NC_005091.ref	NC_025457.alt2	65.2174	46	39912	39957	28229	28310	30	16
NC_005091.ref	NC_025457.alt2	44.4444	45	10713	10757	60699	60662	20	25
NC_005091.ref	NC_025457.alt2	61.3636	44	44478	44521	3583	3515	27	17
NC_005091.ref	NC_025457.alt2	59.0909	44	52714	52757	49746	49666	26	18
NC_005091.ref	NC_025457.alt2	70.4545	44	55606	55649	2999	3064	31	13
NC_005091.ref	NC_025457.alt2	62.7907	43	14472	14514	53771	53739	27	16
NC_005091.ref	NC_025457.alt2	65.8537	41	47486	47526	32256	32308	27	14
NC_005091.ref	NC_025457.alt2	65	40	25248	25287	45225	45186	26	14
NC_005091.ref	NC_025457.alt2	64.1026	39	12038	12076	47142	47094	25	14
NC_005091.ref	NC_025457.alt2	71.7949	39	54831	54869	51634	51704	28	11
NC_005091.ref	NC_025457.alt2	57.8947	38	11128	11165	6922	6896	22	16
NC_005091.ref	NC_025457.alt2	68.4211	38	22268	22305	43144	43084	26	12
NC_005091.ref	NC_025457.alt2	56.7568	37	30795	30831	53078	53133	21	16
NC_005091.ref	NC_025457.alt2	64.8649	37	45504	45540	28029	27993	24	13
NC_005091.ref	NC_025457.alt2	68.5714	35	40527	40561	31536	31570	24	11
NC_025457.ref	NC_002486.ref	46.6667	90	23333	23422	19170	19098	42	48
NC_025457.ref	NC_002486.ref	54.1176	85	39143	39227	43534	43417	46	39
NC_025457.ref	NC_002486.ref	55.8824	68	28977	29044	7466	7545	38	30
NC_025457.ref	NC_002486.ref	60.2941	68	36528	36595	29362	29265	41	27
NC_025457.ref	NC_002486.ref	60.9375	64	5319	5382	16682	16556	39	25
NC_025457.ref	NC_002486.ref	63.7931	58	34578	34635	17795	17875	37	21
NC_025457.ref	NC_002486.ref	40.3509	57	30157	30213	23424	23470	23	34
NC_025457.ref	NC_002486.ref	57.8947	57	32507	32563	10264	10195	33	24
NC_025457.ref	NC_002486.ref	58.9286	56	5724	5779	3547	3484	33	23
NC_025457.ref	NC_002486.ref	58.9286	56	17222	17277	15073	15144	33	23
NC_025457.ref	NC_002486.ref	66.6667	54	10530	10583	31361	31452	36	18
NC_025457.ref	NC_002486.ref	57.6923	52	15742	15793	2199	2111	30	22
NC_025457.ref	NC_002486.ref	65.3846	52	18522	18573	26419	26509	34	18
NC_025457.ref	NC_002486.ref	56.8627	51	24068	24118	43436	43390	29	22
NC_025457.ref	NC_002486.ref	37.2549	51	35206	35256	17903	17946	19	32
NC_025457.ref	NC_002486.ref	54	50	24859	24908	38171	38129	27	23
NC_025457.ref	NC_002486.ref	64	50	38201	38250	1709	1624	32	18
NC_025457.ref	NC_002486.ref	69.3878	49	1879	1927	34767	34821	34	15
NC_025457.ref	NC_002486.ref	59.1837	49	7397	7445	36926	36989	29	20
NC_025457.ref	NC_002486.ref	61.2245	49	13344	13392	9718	9648	30	19
NC_025457.ref	NC_002486.ref	59.1837	49	16816	16864	31253	31319	29	20
NC_025457.ref	NC_002486.ref	61.2245	49	18123	18171	20185	20263	30	19
NC_025457.ref	NC_002486.ref	5e+01	48	1968	2015	7765	7805	24	24
NC_025457.ref	NC_002486.ref	64.5833	48	27272	27319	21909	21964	31	17
NC_025457.ref	NC_002486.ref	61.7021	47	13440	13486	13727	13793	29	18
NC_025457.ref	NC_002486.ref	59.0909	44	4333	4376	20123	20067	26	18
NC_025457.ref	NC_002486.ref	56.8182	44	41752	41795	11116	11194	25	19
NC_025457.ref	NC_002486.ref	62.7907	43	10406	10448	43370	43318	27	16
NC_025457.ref	NC_002486.ref	62.7907	43	24400	24442	32506	32472	27	16
NC_025457.ref	NC_002486.ref	64.2857	42	8159	8200	19211	19266	27	15
NC_025457.ref	NC_002486.ref	57.1429	42	22717	22758	2925	2857	24	18
NC_025457.ref	NC_002486.ref	70.7317	41	11212	11252	25040	25105	29	12
NC_025457.ref	NC_002486.ref	53.6585	41	28288	28328	42600	42658	22	19
NC_025457.ref	NC_002486.ref	57.5	40	11138	11177	33603	33641	23	17
NC_025457.ref	NC_002486.ref	60.5263	38	20795	20832	34953	34891	23	15
NC_025457.ref	NC_002486.ref	65.7895	38	34118	34155	8798	8722	25	13
NC_025457.ref	NC_002486.ref	78.3784	37	4098	4134	10286	10358	29	8
NC_025457.ref	NC_002486.ref	59.4595	37	30658	30694	35138	35195	22	15
NC_025457.ref	NC_002486.ref	72.2222	36	15284	15319	11129	11203	26	10
NC_025457.ref	NC_002486.ref	66.6667	36	29741	29776	2008	2073	24	12
NC_025457.ref	NC_002486.ref	69.4444	36	32655	32690	25030	24984	25	11
NC_025457.ref	NC_002486.ref	62.8571	35	2201	2235	27055	27016	22	13
NC_002486.alt	NC_010807.alt2	43.5897	78	5341	5418	19388	19453	34	44
NC_002486.alt	NC_010807.alt2	54.1667	72	36538	36609	39938	39873	39	33
NC_002486.alt	NC_010807.alt2	55.8824	68	8926	8993	29724	29803	38	30
NC_002486.alt	NC_010807.alt2	54.5455	66	17583	17648	18216	18138	36	30
NC_002486.alt	NC_010807.alt2	52.3077	65	36838	36902	36410	36467	34	31
NC_002486.alt	NC_010807.alt2	56.25	64	24205	24268	23784	23696	36	28
NC_002486.alt	NC_010807.alt2	58.7302	63	10715	10777	22417	22511	37	26
NC_002486.alt	NC_010807.alt2	64.4068	59	23709	23767	36966	36882	38	21
NC_002486.alt	NC_010807.alt2	49.1525	59	33557	33615	16042	15991	29	30
NC_002486.alt	NC_010807.alt2	51.7857	56	19855	19910	31591	31546	29	27
NC_002486.alt	NC_010807.alt2	55.3571	56	31452	31507	19638	19571	31	25
NC_002486.alt	NC_010807.alt2	52.7273	55	40868	40922	21356	21264	29	26
NC_002486.alt	NC_010807.alt2	56.3636	55	41624	41678	9371	9430	31	24
NC_002486.alt	NC_010807.alt2	52.8302	53	34528	34580	19427	19500	28	25
NC_002486.alt	NC_010807.alt2	53.8462	52	7721	7772	28835	28877	28	24
NC_002486.alt	NC_010807.alt2	50.9804	51	17441	17491	35861	35796	26	25
NC_002486.alt	NC_010807.alt2	54	50	25395	25444	40119	40081	27	23
NC_002486.alt	NC_010807.alt2	57.1429	49	8157	8205	34682	34726	28	21
NC_002486.alt	NC_010807.alt2	59.1837	49	21904	21952	20336	20256	29	20
NC_002486.alt	NC_010807.alt2	58.3333	48	4609	4656	16165	16131	28	20
NC_002486.alt	NC_010807.alt2	66.6667	48	38796	38843	5508	5437	32	16
NC_002486.alt	NC_010807.alt2	58.3333	48	40930	40977	24483	24521	28	20
NC_002486.alt	NC_010807.alt2	67.3913	46	1446	1491	18765	18684	31	15
NC_002486.alt	NC_010807.alt2	65.2174	46	4791	4836	16954	16986	30	16
NC_002486.alt	NC_010807.alt2	67.3913	46	10951	10996	7660	7601	31	15
NC_002486.alt	NC_010807.alt2	67.4419	43	7635	7677	34283	34237	29	14
NC_002486.alt	NC_010807.alt2	70.7317	41	28491	28531	11448	11512	29	12
NC_002486.alt	NC_010807.alt2	74.3590	39	29465	29503	18347	18279	29	10
NC_002486.alt	NC_010807.alt2	71.0526	38	29989	30026	38188	38255	27	11
NC_002486.alt	NC_010807.alt2	55.2632	38	39502	39539	25934	25973	21	17
NC_002486.alt	NC_010807.alt2	72.9730	37	43788	43824	26460	26513	27	10
NC_002486.alt	NC_010807.alt2	69.4444	36	25723	25758	37333	37404	25	11
NC_002486.alt	NC_025457.alt1	49.4253	87	16857	16943	16476	16394	43	44
NC_002486.alt	NC_025457.alt1	59.0361	83	44358	44440	26159	26073	49	34
NC_002486.alt	NC_025457.alt1	61.1111	72	19911	19982	23286	23407	44	28
NC_002486.alt	NC_025457.alt1	5e+01	72	45497	45568	16503	16562	36	36
NC_002486.alt	NC_025457.alt1	54.9296	71	30913	30983	26811	26923	39	32
NC_002486.alt	NC_025457.alt1	52.2388	67	20347	20413	11376	11467	35	32
NC_002486.alt	NC_025457.alt1	56.9231	65	44814	44878	25344	25256	37	28
NC_002486.alt	NC_025457.alt1	51.6667	60	19333	19392	17620	17562	31	29
NC_002486.alt	NC_025457.alt1	4e+01	60	28600	28659	23911	23861	24	36
NC_002486.alt	NC_025457.alt1	6e+01	60	40794	40853	7727	7779	36	24
NC_002486.alt	NC_025457.alt1	56.6667	60	41006	41065	14729	14779	34	26
NC_002486.alt	NC_025457.alt1	57.6271	59	39300	39358	6515	6589	34	25
NC_002486.alt	NC_025457.alt1	58.6207	58	6444	6501	33337	33382	34	24
NC_002486.alt	NC_025457.alt1	64.2857	56	12671	12726	424	475	36	20
NC_002486.alt	NC_025457.alt1	73.2143	56	26047	26102	31325	31430	41	15
NC_002486.alt	NC_025457.alt1	54.5455	55	4189	4243	24693	24646	30	25
NC_002486.alt	NC_025457.alt1	54.5455	55	8418	8472	19875	19817	30	25
NC_002486.alt	NC_025457.alt1	52.7273	55	9752	9806	1449	1408	29	26
NC_002486.alt	NC_025457.alt1	65.4545	55	22663	22717	493	426	36	19
NC_002486.alt	NC_025457.alt1	56.3636	55	27724	27778	33344	33296	31	24
NC_002486.alt	NC_025457.alt1	52.7273	55	37957	38011	32100	32164	29	26
NC_002486.alt	NC_025457.alt1	52.7273	55	41850	41904	5646	5725	29	26
NC_002486.alt	NC_025457.alt1	50.9091	55	43098	43152	16076	16029	28	27
NC_002486.alt	NC_025457.alt1	52.8302	53	35557	35609	558	522	28	25
NC_002486.alt	NC_025457.alt1	61.5385	52	40615	40666	17993	18061	32	20
NC_002486.alt	NC_025457.alt1	63.2653	49	10664	10712	11496	11563	31	18
NC_002486.alt	NC_025457.alt1	55.1020	49	23796	23844	1742	1701	27	22
NC_002486.alt	NC_025457.alt1	57.1429	49	30352	30400	19875	19809	28	21
NC_002486.alt	NC_025457.alt1	60.4167	48	17383	17430	21988	21907	29	19
NC_002486.alt	NC_025457.alt1	66.6667	48	32080	32127	31456	31527	32	16
NC_002486.alt	NC_025457.alt1	44.6809	47	30085	30131	27811	27849	21	26
NC_002486.alt	NC_025457.alt1	64.4444	45	35958	36002	15649	15613	29	16
NC_002486.alt	NC_025457.alt1	65.9091	44	343	386	16594	16623	29	15
NC_002486.alt	NC_025457.alt1	65.9091	44	9295	9338	7012	6939	29	15
NC_002486.alt	NC_025457.alt1	64.2857	42	12131	12172	32634	32603	27	15
NC_002486.alt	NC_025457.alt1	66.6667	42	40710	40751	3659	3708	28	14
NC_002486.alt	NC_025457.alt1	66.6667	42	41698	41739	34241	34305	28	14
NC_002486.alt	NC_025457.alt1	51.2195	41	37147	37187	14942	14974	21	20
NC_002486.alt	NC_025457.alt1	68.4211	38	27331	27368	11391	11356	26	12
NC_002486.alt	NC_025457.alt1	62.1622	37	16450	16486	34816	34765	23	14
NC_002486.alt	NC_025457.alt1	75.6757	37	24096	24132	27025	27067	28	9
NC_002486.alt	NC_025457.alt1	61.1111	36	11385	11420	34372	34298	22	14
NC_002486.alt	NC_025457.alt1	72.2222	36	37881	37916	20859	20803	26	10
NC_002486.alt	NC_025457.alt1	61.1111	36	38182	38217	16919	16958	22	14
NC_025457.ref	NC_005091.ref	38.7097	62	15140	15201	37586	37533	24	38
NC_025457.ref	NC_005091.ref	55.9322	59	7200	7258	8955	9030	33	26
NC_025457.ref	NC_005091.ref	55.1724	58	21745	21802	49622	49674	32	26
NC_025457.ref	NC_005091.ref	52.6316	57	27795	27851	20173	20096	30	27
NC_025457.ref	NC_005091.ref	60.7143	56	4811	4866	20463	20554	34	22
NC_025457.ref	NC_005091.ref	44.6429	56	18006	18061	9183	9135	25	31
NC_025457.ref	NC_005091.ref	50.9434	53	3563	3615	49400	49325	27	26
NC_025457.ref	NC_005091.ref	64.7059	51	27065	27115	29925	29888	33	18
NC_025457.ref	NC_005091.ref	57.1429	49	7997	8045	2575	2632	28	21
NC_025457.ref	NC_005091.ref	61.2245	49	28856	28904	39785	39703	30	19
NC_025457.ref	NC_005091.ref	58.3333	48	13117	13164	49431	49388	28	20
NC_025457.ref	NC_005091.ref	47.9167	48	20723	20770	49435	49400	23	25
NC_025457.ref	NC_005091.ref	57.4468	47	15998	16044	17086	17122	27	20
NC_025457.ref	NC_005091.ref	64.2857	42	19324	19365	55046	55095	27	15
NC_025457.ref	NC_005091.ref	68.2927	41	11744	11784	51690	51619	28	13
NC_025457.ref	NC_005091.ref	62.5	40	13698	13737	11787	11759	25	15
NC_025457.ref	NC_005091.ref	62.5	40	30768	30807	29677	29623	25	15
NC_025457.ref	NC_005091.ref	72.5	40	40556	40595	32449	32398	29	11
NC_025457.ref	NC_005091.ref	66.6667	39	359	397	47789	47857	26	13
NC_025457.ref	NC_005091.ref	65.7895	38	17580	17617	14795	14724	25	13
NC_025457.ref	NC_005091.ref	70.2703	37	6499	6535	44846	44882	26	11
NC_025457.ref	NC_005091.ref	82.8571	35	19127	19161	20434	20470	29	6
NC_002486.alt	NC_010807.ref	54.3478	92	39146	39237	28243	28370	50	42
NC_002486.alt	NC_010807.ref	48.8095	84	4791	4874	16165	16228	41	43
NC_002486.alt	NC_010807.ref	43.5897	78	5341	5418	18444	18509	34	44
NC_002486.alt	NC_010807.ref	54.1667	72	36538	36609	38198	38133	39	33
NC_002486.alt	NC_010807.ref	55.8824	68	8926	8993	28691	28770	38	30
NC_002486.alt	NC_010807.ref	52.3077	65	36838	36902	34843	34900	34	31
NC_002486.alt	NC_010807.ref	54.6875	64	24205	24268	22840	22752	35	29
NC_002486.alt	NC_010807.ref	58.7302	63	10715	10777	21473	21567	37	26
NC_002486.alt	NC_010807.ref	55.7377	61	36408	36468	37512	37437	34	27
NC_002486.alt	NC_010807.ref	49.1525	59	33557	33615	15253	15202	29	30
NC_002486.alt	NC_010807.ref	51.7857	56	19855	19910	30280	30235	29	27
NC_002486.alt	NC_010807.ref	55.3571	56	31452	31507	18694	18627	31	25
NC_002486.alt	NC_010807.ref	53.8462	52	7721	7772	27802	27844	28	24
NC_002486.alt	NC_010807.ref	51.9231	52	17441	17492	34294	34209	27	25
NC_002486.alt	NC_010807.ref	54	50	25395	25444	38379	38341	27	23
NC_002486.alt	NC_010807.ref	57.1429	49	8157	8205	33115	33159	28	21
NC_002486.alt	NC_010807.ref	59.1837	49	21904	21952	19392	19312	29	20
NC_002486.alt	NC_010807.ref	58.3333	48	4609	4656	15376	15342	28	20
NC_002486.alt	NC_010807.ref	58.3333	48	40930	40977	23450	23488	28	20
NC_002486.alt	NC_010807.ref	67.3913	46	1446	1491	17821	17740	31	15
NC_002486.alt	NC_010807.ref	67.3913	46	10951	10996	7074	7015	31	15
NC_002486.alt	NC_010807.ref	65.9091	44	38796	38839	5230	5163	29	15
NC_002486.alt	NC_010807.ref	70.7317	41	28491	28531	10752	10816	29	12
NC_002486.alt	NC_010807.ref	74.3590	39	29465	29503	17403	17335	29	10
NC_002486.alt	NC_010807.ref	71.0526	38	29989	30026	36448	36515	27	11
NC_002486.alt	NC_010807.ref	55.2632	38	39502	39539	24901	24940	21	17
NC_002486.alt	NC_010807.ref	72.9730	37	43788	43824	25427	25480	27	10
NC_002486.alt	NC_010807.ref	65.7143	35	21500	21534	33596	33571	23	12
NC_002486.alt	NC_010807.alt3	54.3478	92	39146	39237	3021	3148	50	42
NC_002486.alt	NC_010807.alt3	48.8095	84	4791	4874	16418	16477	41	43
NC_002486.alt	NC_010807.alt3	43.5897	78	5341	5418	19091	19156	34	44
NC_002486.alt	NC_010807.alt3	67.9487	78	13594	13671	11903	11811	53	25
NC_002486.alt	NC_010807.alt3	54.1667	72	36538	36609	39274	39209	39	33
NC_002486.alt	NC_010807.alt3	55.8824	68	8926	8993	28668	28747	38	30
NC_002486.alt	NC_010807.alt3	52.3077	65	36838	36902	35535	35592	34	31
NC_002486.alt	NC_010807.alt3	54.6875	64	24205	24268	23270	23182	35	29
NC_002486.alt	NC_010807.alt3	58.7302	63	10715	10777	21794	21888	37	26
NC_002486.alt	NC_010807.alt3	55.7377	61	36408	36468	38588	38513	34	27
NC_002486.alt	NC_010807.alt3	49.1525	59	33557	33615	15506	15455	29	30
NC_002486.alt	NC_010807.alt3	51.7857	56	19855	19910	30532	30487	29	27
NC_002486.alt	NC_010807.alt3	55.3571	56	31452	31507	19341	19274	31	25
NC_002486.alt	NC_010807.alt3	62.9630	54	1446	1499	18258	18169	34	20
NC_002486.alt	NC_010807.alt3	56.6038	53	16536	16588	23841	23931	30	23
NC_002486.alt	NC_010807.alt3	53.8462	52	7721	7772	27941	27983	28	24
NC_002486.alt	NC_010807.alt3	54	50	25395	25444	39455	39417	27	23
NC_002486.alt	NC_010807.alt3	57.1429	49	8157	8205	33598	33642	28	21
NC_002486.alt	NC_010807.alt3	59.1837	49	21904	21952	37646	37566	29	20
NC_002486.alt	NC_010807.alt3	58.3333	48	4609	4656	15629	15595	28	20
NC_002486.alt	NC_010807.alt3	58.3333	48	40930	40977	23975	24013	28	20
NC_002486.alt	NC_010807.alt3	67.3913	46	10951	10996	7364	7305	31	15
NC_002486.alt	NC_010807.alt3	65.9091	44	38796	38839	5667	5600	29	15
NC_002486.alt	NC_010807.alt3	70.7317	41	28491	28531	10968	11032	29	12
NC_002486.alt	NC_010807.alt3	71.0526	38	29989	30026	37456	37523	27	11
NC_002486.alt	NC_010807.alt3	55.2632	38	39502	39539	3551	3512	21	17
NC_002486.alt	NC_010807.alt3	72.9730	37	43788	43824	25773	25826	27	10
NC_002486.alt	NC_010807.alt3	65.7143	35	21500	21534	34079	34054	23	12
NC_002486.ref	NC_025457.ref	42.0455	88	10797	10884	3947	3832	37	51
NC_002486.ref	NC_025457.ref	63.2911	79	26940	27018	21377	21224	50	29
NC_002486.ref	NC_025457.ref	5e+01	72	15073	15144	17222	17281	36	36
NC_002486.ref	NC_025457.ref	39.3939	66	38496	38561	5041	5096	26	40
NC_002486.ref	NC_025457.ref	52.3077	65	8718	8782	2070	2135	34	31
NC_002486.ref	NC_025457.ref	56.9231	65	14390	14454	26527	26439	37	28
NC_002486.ref	NC_025457.ref	45.9016	61	28597	28657	6138	6190	28	33
NC_002486.ref	NC_025457.ref	6e+01	60	10370	10429	8030	8082	36	24
NC_002486.ref	NC_025457.ref	56.6667	60	10582	10641	15409	15459	34	26
NC_002486.ref	NC_025457.ref	43.1034	58	35138	35195	30658	30706	25	33
NC_002486.ref	NC_025457.ref	58.6207	58	36868	36925	35209	35254	34	24
NC_002486.ref	NC_025457.ref	57.1429	56	38042	38097	506	584	32	24
NC_002486.ref	NC_025457.ref	52.7273	55	7533	7587	33259	33323	29	26
NC_002486.ref	NC_025457.ref	50.9091	55	12674	12728	16795	16748	28	27
NC_002486.ref	NC_025457.ref	6e+01	55	16966	17020	29178	29223	33	22
NC_002486.ref	NC_025457.ref	54.5455	55	34613	34667	26066	26019	30	25
NC_002486.ref	NC_025457.ref	52.7273	55	40176	40230	1377	1336	29	26
NC_002486.ref	NC_025457.ref	62.2642	53	14006	14058	28902	28849	33	20
NC_002486.ref	NC_025457.ref	59.6154	52	10191	10242	18888	18956	31	21
NC_002486.ref	NC_025457.ref	56.8627	51	6667	6717	40484	40538	29	22
NC_002486.ref	NC_025457.ref	56.8627	51	17792	17842	2497	2531	29	22
NC_002486.ref	NC_025457.ref	45.0980	51	18075	18125	33263	33220	23	28
NC_002486.ref	NC_025457.ref	58.6957	46	9653	9698	11140	11183	27	19
NC_002486.ref	NC_025457.ref	71.7391	46	11273	11318	24789	24744	33	13
NC_002486.ref	NC_025457.ref	58.6957	46	19032	19077	25260	25225	27	19
NC_002486.ref	NC_025457.ref	65.9091	44	34207	34250	8579	8623	29	15
NC_002486.ref	NC_025457.ref	61.3636	44	35471	35514	29812	29780	27	17
NC_002486.ref	NC_025457.ref	60.4651	43	10069	10111	2163	2118	26	17
NC_002486.ref	NC_025457.ref	60.4651	43	20739	20781	35771	35837	26	17
NC_002486.ref	NC_025457.ref	71.4286	42	2767	2808	15892	15851	30	12
NC_002486.ref	NC_025457.ref	64.2857	42	10286	10327	4098	4162	27	15
NC_002486.ref	NC_025457.ref	66.6667	42	26414	26455	37114	37173	28	14
NC_002486.ref	NC_025457.ref	51.2195	41	6723	6763	15865	15897	21	20
NC_002486.ref	NC_025457.ref	77.5	40	9050	9089	14835	14876	31	9
NC_002486.ref	NC_025457.ref	61.5385	39	33603	33641	11138	11177	24	15
NC_002486.ref	NC_025457.ref	76.9231	39	37801	37839	24724	24777	30	9
NC_002486.ref	NC_025457.ref	84.2105	38	1049	1086	39240	39133	32	6
NC_002486.ref	NC_025457.ref	65.7895	38	19461	19498	7473	7507	25	13
NC_002486.ref	NC_025457.ref	57.8947	38	36053	36090	36371	36400	22	16
NC_002486.ref	NC_025457.ref	64.8649	37	42288	42324	42231	42198	24	13
NC_002486.ref	NC_025457.ref	61.1111	36	7758	7793	17814	17853	22	14
NC_002486.ref	NC_025457.ref	63.8889	36	17727	17762	12629	12599	23	13
NC_002486.ref	NC_025457.ref	68.5714	35	1647	1681	19826	19860	24	11
NC_002486.ref	NC_010807.alt1	54.3478	92	8722	8813	28243	28370	50	42
NC_002486.ref	NC_010807.alt1	48.8095	84	35215	35298	16049	16112	41	43
NC_002486.ref	NC_010807.alt1	43.5897	78	35765	35842	18328	18393	34	44
NC_002486.ref	NC_010807.alt1	54.1667	72	6114	6185	38198	38133	39	33
NC_002486.ref	NC_010807.alt1	55.8824	68	39350	39417	28691	28770	38	30
NC_002486.ref	NC_010807.alt1	52.3077	65	6414	6478	34843	34900	34	31
NC_002486.ref	NC_010807.alt1	58.7302	63	41139	41201	21473	21567	37	26
NC_002486.ref	NC_010807.alt1	55.7377	61	5984	6044	37512	37437	34	27
NC_002486.ref	NC_010807.alt1	49.1525	59	3133	3191	14975	14924	29	30
NC_002486.ref	NC_010807.alt1	47.3684	57	25678	25734	9885	9980	27	30
NC_002486.ref	NC_010807.alt1	55.3571	56	1028	1083	18578	18511	31	25
NC_002486.ref	NC_010807.alt1	57.1429	56	4606	4661	10161	10262	32	24
NC_002486.ref	NC_010807.alt1	58.4906	53	20899	20951	9284	9213	31	22
NC_002486.ref	NC_010807.alt1	57.6923	52	19907	19958	6555	6644	30	22
NC_002486.ref	NC_010807.alt1	53.8462	52	38145	38196	27802	27844	28	24
NC_002486.ref	NC_010807.alt1	57.1429	49	38581	38629	33115	33159	28	21
NC_002486.ref	NC_010807.alt1	58.3333	48	10506	10553	23450	23488	28	20
NC_002486.ref	NC_010807.alt1	58.3333	48	35033	35080	15098	15064	28	20
NC_002486.ref	NC_010807.alt1	67.3913	46	31870	31915	17705	17624	31	15
NC_002486.ref	NC_010807.alt1	65.9091	44	8372	8415	4604	4537	29	15
NC_002486.ref	NC_010807.alt1	58.5366	41	23542	23582	22805	22742	24	17
NC_002486.ref	NC_010807.alt1	55.2632	38	9078	9115	24901	24940	21	17
NC_002486.ref	NC_010807.alt1	72.9730	37	13364	13400	25427	25480	27	10
NC_002486.ref	NC_010807.alt1	77.1429	35	16868	16902	15368	15418	27	8
NC_002486.ref	NC_010807.alt1	62.8571	35	22651	22685	3821	3759	22	13
NC_025457.ref	NC_005091.alt1	56.3380	71	36598	36668	57139	57031	40	31
NC_025457.ref	NC_005091.alt1	62.0690	58	512	569	57169	57085	36	22
NC_025457.ref	NC_005091.alt1	55.1724	58	21745	21802	49871	49923	32	26
NC_025457.ref	NC_005091.alt1	53.5714	56	27796	27851	20172	20096	30	26
NC_025457.ref	NC_005091.alt1	62	50	13900	13949	29915	29961	31	19
NC_025457.ref	NC_005091.alt1	61.2245	49	28856	28904	40091	40009	30	19
NC_025457.ref	NC_005091.alt1	56.25	48	13117	13164	49680	49637	27	21
NC_025457.ref	NC_005091.alt1	47.9167	48	20723	20770	49684	49649	23	25
NC_025457.ref	NC_005091.alt1	57.4468	47	15998	16044	17086	17122	27	20
NC_025457.ref	NC_005091.alt1	59.5745	47	30936	30982	41820	41762	28	19
NC_025457.ref	NC_005091.alt1	59.5745	47	33668	33714	33140	33092	28	19
NC_025457.ref	NC_005091.alt1	6e+01	45	29314	29358	3447	3415	27	18
NC_025457.ref	NC_005091.alt1	65.1163	43	30075	30117	45534	45590	28	15
NC_025457.ref	NC_005091.alt1	71.4286	42	13849	13890	42571	42532	30	12
NC_025457.ref	NC_005091.alt1	59.5238	42	17949	17990	18279	18326	25	17
NC_025457.ref	NC_005091.alt1	66.6667	42	41196	41237	42927	42971	28	14
NC_025457.ref	NC_005091.alt1	68.2927	41	11744	11784	51939	51868	28	13
NC_025457.ref	NC_005091.alt1	62.5	40	13698	13737	11787	11759	25	15
NC_025457.ref	NC_005091.alt1	72.5	40	40556	40595	32658	32709	29	11
NC_025457.ref	NC_005091.alt1	66.6667	39	359	397	47951	48019	26	13
NC_025457.ref	NC_005091.alt1	65.7895	38	17580	17617	14795	14724	25	13
NC_025457.ref	NC_005091.alt1	70.2703	37	6499	6535	45008	45044	26	11
NC_025457.ref	NC_005091.alt1	77.1429	35	19127	19161	20434	20470	27	8
NC_025457.ref	NC_005091.alt2	41.0526	95	13244	13338	53813	53719	39	56
NC_025457.ref	NC_005091.alt2	43.8356	73	40863	40935	24813	24750	32	41
NC_025457.ref	NC_005091.alt2	5e+01	70	6499	6568	49007	49068	35	35
NC_025457.ref	NC_005091.alt2	38.7097	62	15140	15201	41750	41697	24	38
NC_025457.ref	NC_005091.alt2	60.6557	61	16007	16067	19379	19461	37	24
NC_025457.ref	NC_005091.alt2	55.9322	59	10979	11037	15578	15665	33	26
NC_025457.ref	NC_005091.alt2	44.6429	56	18006	18061	10053	10005	25	31
NC_025457.ref	NC_005091.alt2	69.3878	49	29878	29926	43705	43621	34	15
NC_025457.ref	NC_005091.alt2	58.3333	48	13117	13164	54350	54307	28	20
NC_025457.ref	NC_005091.alt2	58.3333	48	28006	28053	63401	63357	28	20
NC_025457.ref	NC_005091.alt2	65.9574	47	22819	22865	19103	19165	31	16
NC_025457.ref	NC_005091.alt2	64.4444	45	29138	29182	9785	9839	29	16
NC_025457.ref	NC_005091.alt2	65.1163	43	40097	40139	24157	24207	28	15
NC_025457.ref	NC_005091.alt2	68.2927	41	11744	11784	56901	56830	28	13
NC_025457.ref	NC_005091.alt2	63.4146	41	30768	30808	32848	32793	26	15
NC_025457.ref	NC_005091.alt2	66.6667	39	6896	6934	18028	18091	26	13
NC_025457.alt1	NC_025457.ref	99.6616	1773	16669	18441	17564	19336	1767	6
NC_025457.alt1	NC_025457.ref	98.5521	1036	19782	20817	20977	22012	1021	15
NC_025457.alt1	NC_025457.ref	99.5855	965	35351	36315	36959	37923	961	4
NC_025457.alt1	NC_025457.ref	98.8248	936	34415	35350	36119	37054	925	11
NC_025457.alt1	NC_025457.ref	99.6552	870	31349	32218	32508	33377	867	3
NC_025457.alt1	NC_025457.ref	99.6355	823	39687	40509	41430	42289	820	3
NC_025457.alt1	NC_025457.ref	96.2963	810	551	1360	713	1488	780	30
NC_025457.alt1	NC_025457.ref	99.3781	804	15865	16668	16584	17387	799	5
NC_025457.alt1	NC_025457.ref	99.6236	797	21306	22102	22531	23327	794	3
NC_025457.alt1	NC_025457.ref	99.8736	791	24146	24936	25519	26309	790	1
NC_025457.alt1	NC_025457.ref	98.8266	767	33192	33958	35064	35869	758	9
NC_025457.alt1	NC_025457.ref	98.9568	671	4971	5641	5456	6126	664	7
NC_025457.alt1	NC_025457.ref	99.2470	664	18593	19256	19892	20555	659	5
NC_025457.alt1	NC_025457.ref	99.1909	618	2460	3077	2663	3289	613	5
NC_025457.alt1	NC_025457.ref	99.4983	598	28888	29485	30078	30675	595	3
NC_025457.alt1	NC_025457.ref	98.9865	592	7453	8044	7756	8347	586	6
NC_025457.alt1	NC_025457.ref	99.4545	550	1	550	1	550	547	3
NC_025457.alt1	NC_025457.ref	99.8110	529	24937	25465	26120	26648	528	1
NC_025457.alt1	NC_025457.ref	98.5294	476	23009	23484	23937	24441	469	7
NC_025457.alt1	NC_025457.ref	97.2516	473	26850	27322	27827	28286	460	13
NC_025457.alt1	NC_025457.ref	99.1525	472	30325	30796	31358	31829	468	4
NC_025457.alt1	NC_025457.ref	99.1471	469	6022	6490	6722	7190	465	4
NC_025457.alt1	NC_025457.ref	99.5652	460	14136	14595	14573	15032	458	2
NC_025457.alt1	NC_025457.ref	1e+02	455	10170	10624	10584	11038	455	0
NC_025457.alt1	NC_025457.ref	99.3318	449	12636	13084	13385	13833	446	3
NC_025457.alt1	NC_025457.ref	99.7743	443	27323	27765	28367	28809	442	1
NC_025457.alt1	NC_025457.ref	99.2908	423	12132	12554	12899	13321	420	3
NC_025457.alt1	NC_025457.ref	99.7608	418	30931	31348	31972	32389	417	1
NC_025457.alt1	NC_025457.ref	99.2806	417	9560	9976	9989	10405	414	3
NC_025457.alt1	NC_025457.ref	98.4615	390	27766	28155	29028	29417	384	6
NC_025457.alt1	NC_025457.ref	99.4778	383	25583	25965	26649	27048	381	2
NC_025457.alt1	NC_025457.ref	96.7914	374	23575	23948	24878	25294	362	12
NC_025457.alt1	NC_025457.ref	96.9697	363	29615	29977	30892	31254	352	11
NC_025457.alt1	NC_025457.ref	99.4490	363	37692	38054	39309	39686	361	2
NC_025457.alt1	NC_025457.ref	1e+02	356	36577	36932	38300	38690	356	0
NC_025457.alt1	NC_025457.ref	98.8338	343	1617	1959	1499	1869	339	4
NC_025457.alt1	NC_025457.ref	98.8024	334	8144	8477	8337	8670	330	4
NC_025457.alt1	NC_025457.ref	99.6951	328	6654	6981	7214	7541	327	1
NC_025457.alt1	NC_025457.ref	1e+02	328	8860	9187	9520	9847	328	0
NC_025457.alt1	NC_025457.ref	97.7199	307	8496	8802	9214	9520	300	7
NC_025457.alt1	NC_025457.ref	98.0132	302	13427	13728	13873	14174	296	6
NC_025457.alt1	NC_025457.ref	99.3355	301	38169	38469	40150	40450	299	2
NC_025457.alt1	NC_025457.ref	93.5811	296	3141	3436	3484	3751	277	19
NC_025457.alt1	NC_025457.ref	99.3151	292	3555	3846	3994	4300	290	2
NC_025457.alt1	NC_025457.ref	90.9722	288	38986	39273	41126	41426	262	26
NC_025457.alt1	NC_025457.ref	1e+02	272	14831	15102	15739	16025	272	0
NC_025457.alt1	NC_025457.ref	1e+02	270	22277	22546	23414	23683	270	0
NC_025457.alt1	NC_025457.ref	99.6169	261	36316	36576	37798	38058	260	1
NC_025457.alt1	NC_025457.ref	98.4436	257	2079	2335	1861	2117	253	4
NC_025457.alt1	NC_025457.ref	97.6096	251	21055	21305	22444	22694	245	6
NC_025457.alt1	NC_025457.ref	99.5968	248	11753	12000	12652	12899	247	1
NC_025457.alt1	NC_025457.ref	99.1770	243	34124	34366	35869	36128	241	2
NC_025457.alt1	NC_025457.ref	98.7395	238	10725	10962	11408	11645	235	3
NC_025457.alt1	NC_025457.ref	97.8723	235	14596	14830	15276	15510	230	5
NC_025457.alt1	NC_025457.ref	99.1453	234	38752	38985	40786	41019	232	2
NC_025457.alt1	NC_025457.ref	1e+02	232	32960	33191	34619	34850	232	0
NC_025457.alt1	NC_025457.ref	98.6957	230	11170	11399	11799	12028	227	3
NC_025457.alt1	NC_025457.ref	1e+02	228	32219	32446	33223	33450	228	0
NC_025457.alt1	NC_025457.ref	1e+02	211	1361	1571	1289	1499	211	0
NC_025457.alt1	NC_025457.ref	99.5169	207	3847	4053	4444	4650	206	1
NC_025457.alt1	NC_025457.ref	1e+02	204	13781	13984	14175	14402	204	0
NC_025457.alt1	NC_025457.ref	95.9799	199	32684	32882	33973	34171	191	8
NC_025457.alt1	NC_025457.ref	98.9899	198	15240	15437	16024	16221	196	2
NC_025457.alt1	NC_025457.ref	1e+02	196	13085	13280	13685	13880	196	0
NC_025457.alt1	NC_025457.ref	96.8912	193	9977	10169	10497	10689	187	6
NC_025457.alt1	NC_025457.ref	1e+02	174	22103	22276	23374	23547	174	0
NC_025457.alt1	NC_025457.ref	1e+02	170	25966	26135	26914	27083	170	0
NC_025457.alt1	NC_025457.ref	1e+02	169	37332	37500	38734	38902	169	0
NC_025457.alt1	NC_025457.ref	95.8333	168	4447	4614	5296	5463	161	7
NC_025457.alt1	NC_025457.ref	1e+02	159	11594	11752	12299	12457	159	0
NC_025457.alt1	NC_025457.ref	97.4522	157	15708	15864	16575	16419	153	4
NC_025457.alt1	NC_025457.ref	99.3103	145	38470	38614	40504	40648	144	1
NC_025457.alt1	NC_025457.ref	1e+02	144	11450	11593	12028	12171	144	0
NC_025457.alt1	NC_025457.ref	99.2908	141	24005	24145	25285	25425	140	1
NC_025457.alt1	NC_025457.ref	99.2908	141	26376	26516	27221	27361	140	1
NC_025457.alt1	NC_025457.ref	1e+02	138	40929	41066	42517	42654	138	0
NC_025457.alt1	NC_025457.ref	1e+02	137	38615	38751	40784	40648	137	0
NC_025457.alt1	NC_025457.ref	1e+02	135	22547	22681	23818	23684	135	0
NC_025457.alt1	NC_025457.ref	1e+02	134	30797	30930	31918	32051	134	0
NC_025457.alt1	NC_025457.ref	93.2331	133	20872	21004	22332	22494	124	9
NC_025457.alt1	NC_025457.ref	96.875	128	4615	4742	5340	5467	124	4
NC_025457.alt1	NC_025457.ref	1e+02	124	2336	2459	2290	2413	124	0
NC_025457.alt1	NC_025457.ref	99.1870	123	5642	5764	6269	6391	122	1
NC_025457.alt1	NC_025457.ref	99.1870	123	26725	26847	27361	27483	122	1
NC_025457.alt1	NC_025457.ref	99.1525	118	22682	22799	23819	23936	117	1
NC_025457.alt1	NC_025457.ref	1e+02	116	40510	40625	42403	42288	116	0
NC_025457.alt1	NC_025457.ref	1e+02	114	28257	28370	29410	29523	114	0
NC_025457.alt1	NC_025457.ref	99.1228	114	38055	38168	39894	40007	113	1
NC_025457.alt1	NC_025457.ref	1e+02	109	6545	6653	7191	7299	109	0
NC_025457.alt1	NC_025457.ref	1e+02	109	28422	28530	29935	30043	109	0
NC_025457.alt1	NC_025457.ref	1e+02	105	4342	4446	5290	5186	105	0
NC_025457.alt1	NC_025457.ref	99.0385	104	30006	30109	31254	31357	103	1
NC_025457.alt1	NC_025457.ref	93.2039	103	37229	37331	38712	38814	96	7
NC_025457.alt1	NC_025457.ref	1e+02	103	37589	37691	39307	39205	103	0
NC_025457.alt1	NC_025457.ref	99	100	10625	10724	11143	11265	99	1
NC_025457.alt1	NC_025457.ref	97.9592	98	4174	4271	4904	5001	96	2
NC_025457.alt1	NC_025457.ref	98.8889	90	23485	23574	24614	24703	89	1
NC_025457.alt1	NC_025457.ref	98.8636	88	37501	37588	39118	39205	87	1
NC_025457.alt1	NC_025457.ref	91.9540	87	32506	32592	33915	34007	80	7
NC_025457.alt1	NC_025457.ref	96.5116	86	7049	7134	7540	7625	83	3
NC_025457.alt1	NC_025457.ref	98.8235	85	13985	14069	14488	14572	84	1
NC_025457.alt1	NC_025457.ref	94.0476	84	40626	40709	42406	42489	79	5
NC_025457.alt1	NC_025457.ref	1e+02	77	32883	32959	34352	34428	77	0
NC_025457.alt1	NC_025457.ref	1e+02	76	18442	18517	19468	19543	76	0
NC_025457.alt1	NC_025457.ref	1e+02	75	18518	18592	19649	19723	75	0
NC_025457.alt1	NC_025457.ref	96	75	19257	19331	20710	20784	72	3
NC_025457.alt1	NC_025457.ref	59.7222	72	9419	9490	7183	7114	43	29
NC_025457.alt1	NC_025457.ref	1e+02	70	4272	4341	5121	5190	70	0
NC_025457.alt1	NC_025457.ref	1e+02	66	39474	39539	41365	41430	66	0
NC_025457.alt1	NC_025457.ref	56.6667	60	19530	19589	20785	20852	34	26
NC_025457.alt1	NC_025457.ref	98.3051	59	32447	32505	33625	33683	58	1
NC_025457.alt1	NC_025457.ref	79.3103	58	3078	3135	3449	3539	46	12
NC_025457.alt1	NC_025457.ref	1e+02	54	20818	20871	22085	22138	54	0
NC_025457.alt1	NC_025457.ref	52.9412	51	39304	39354	33196	33124	27	24
NC_025457.alt1	NC_025457.ref	1e+02	48	28371	28418	29716	29763	48	0
NC_025457.alt1	NC_025457.ref	52.0833	48	37179	37226	30589	30535	25	23
NC_025457.alt1	NC_025457.ref	1e+02	47	26329	26375	27084	27130	47	0
NC_025457.alt1	NC_025457.ref	1e+02	45	15663	15707	16382	16426	45	0
NC_025457.alt1	NC_025457.ref	88.6364	44	36955	36998	38681	38724	39	5
NC_025457.alt1	NC_025457.ref	95	40	28741	28780	30044	30083	38	2
NC_025457.alt1	NC_025457.ref	97.5	40	29486	29525	30866	30905	39	1
NC_025457.alt1	NC_025457.ref	1e+02	39	40829	40867	42479	42517	39	0
NC_025457.alt1	NC_025457.ref	66.6667	36	37108	37143	10462	10504	24	12
NC_025457.alt1	NC_002486.alt	61.1765	85	15612	15696	22165	22041	52	33
NC_025457.alt1	NC_002486.alt	53.6585	82	18806	18887	27342	27239	44	38
NC_025457.alt1	NC_002486.alt	51.4286	70	39688	39757	24071	24156	36	34
NC_025457.alt1	NC_002486.alt	61.7647	68	34824	34891	16275	16372	42	26
NC_025457.alt1	NC_002486.alt	58.4615	65	566	630	8829	8744	38	27
NC_025457.alt1	NC_002486.alt	60.9375	64	4470	4533	28955	29081	39	25
NC_025457.alt1	NC_002486.alt	53.2258	62	30931	30992	36833	36923	33	29
NC_025457.alt1	NC_002486.alt	53.2258	62	31325	31386	26047	26096	33	29
NC_025457.alt1	NC_002486.alt	58.9286	56	5239	5294	33971	33908	33	23
NC_025457.alt1	NC_002486.alt	58.9286	56	16503	16558	45497	45568	33	23
NC_025457.alt1	NC_002486.alt	53.5714	56	37653	37708	38544	38492	30	26
NC_025457.alt1	NC_002486.alt	56.3636	55	3265	3319	439	365	31	24
NC_025457.alt1	NC_002486.alt	66.6667	54	10010	10063	937	1028	36	18
NC_025457.alt1	NC_002486.alt	57.6923	52	14834	14885	32623	32535	30	22
NC_025457.alt1	NC_002486.alt	65.3846	52	17627	17678	19218	19128	34	18
NC_025457.alt1	NC_002486.alt	67.3077	52	32829	32880	39222	39107	35	17
NC_025457.alt1	NC_002486.alt	56.8627	51	23140	23190	13012	12966	29	22
NC_025457.alt1	NC_002486.alt	37.2549	51	33334	33384	27734	27691	19	32
NC_025457.alt1	NC_002486.alt	48	50	40663	40712	7003	7045	24	26
NC_025457.alt1	NC_002486.alt	69.3878	49	2097	2145	4343	4397	34	15
NC_025457.alt1	NC_002486.alt	59.1837	49	6837	6885	6502	6565	29	20
NC_025457.alt1	NC_002486.alt	59.1837	49	16097	16145	829	895	29	20
NC_025457.alt1	NC_002486.alt	61.2245	49	17228	17276	25452	25374	30	19
NC_025457.alt1	NC_002486.alt	5e+01	48	2186	2233	38189	38229	24	24
NC_025457.alt1	NC_002486.alt	61.7021	47	12691	12737	44151	44217	29	18
NC_025457.alt1	NC_002486.alt	59.5745	47	37526	37572	13110	13026	28	19
NC_025457.alt1	NC_002486.alt	51.1628	43	2323	2365	16309	16274	22	21
NC_025457.alt1	NC_002486.alt	64.2857	42	7856	7897	26426	26371	27	15
NC_025457.alt1	NC_002486.alt	57.1429	42	21492	21533	33349	33281	24	18
NC_025457.alt1	NC_002486.alt	66.6667	39	30364	30402	27566	27628	26	13
NC_025457.alt1	NC_002486.alt	71.0526	38	23482	23519	12554	12612	27	11
NC_025457.alt1	NC_002486.alt	77.7778	36	3659	3694	40710	40781	28	8
NC_025457.alt1	NC_002486.alt	71.4286	35	28935	28969	25256	25329	25	10
NC_002486.ref	NC_010807.alt2	43.5897	78	35765	35842	19388	19453	34	44
NC_002486.ref	NC_010807.alt2	54.1667	72	6114	6185	39938	39873	39	33
NC_002486.ref	NC_010807.alt2	55.8824	68	39350	39417	29724	29803	38	30
NC_002486.ref	NC_010807.alt2	52.3077	65	6414	6478	36410	36467	34	31
NC_002486.ref	NC_010807.alt2	42.1875	64	26987	27050	18807	18858	27	37
NC_002486.ref	NC_010807.alt2	58.7302	63	41139	41201	22417	22511	37	26
NC_002486.ref	NC_010807.alt2	49.1525	59	3133	3191	16042	15991	29	30
NC_002486.ref	NC_010807.alt2	47.3684	57	25678	25734	11207	11302	27	30
NC_002486.ref	NC_010807.alt2	55.3571	56	1028	1083	19638	19571	31	25
NC_002486.ref	NC_010807.alt2	52.7273	55	10444	10498	21356	21264	29	26
NC_002486.ref	NC_010807.alt2	56.3636	55	11200	11254	9371	9430	31	24
NC_002486.ref	NC_010807.alt2	52.8302	53	4104	4156	19427	19500	28	25
NC_002486.ref	NC_010807.alt2	51.9231	52	29609	29660	32023	31968	27	25
NC_002486.ref	NC_010807.alt2	53.8462	52	38145	38196	28835	28877	28	24
NC_002486.ref	NC_010807.alt2	57.1429	49	38581	38629	34682	34726	28	21
NC_002486.ref	NC_010807.alt2	66.6667	48	8372	8419	5508	5437	32	16
NC_002486.ref	NC_010807.alt2	58.3333	48	10506	10553	24483	24521	28	20
NC_002486.ref	NC_010807.alt2	58.3333	48	35033	35080	16165	16131	28	20
NC_002486.ref	NC_010807.alt2	73.9130	46	18451	18496	30321	30405	34	12
NC_002486.ref	NC_010807.alt2	67.3913	46	31870	31915	18765	18684	31	15
NC_002486.ref	NC_010807.alt2	65.2174	46	35215	35260	16954	16986	30	16
NC_002486.ref	NC_010807.alt2	67.3913	46	41375	41420	7660	7601	31	15
NC_002486.ref	NC_010807.alt2	66.6667	45	20460	20504	808	850	30	15
NC_002486.ref	NC_010807.alt2	67.4419	43	38059	38101	34283	34237	29	14
NC_002486.ref	NC_010807.alt2	58.5366	41	23542	23582	23749	23686	24	17
NC_002486.ref	NC_010807.alt2	55.2632	38	9078	9115	25934	25973	21	17
NC_002486.ref	NC_010807.alt2	72.9730	37	13364	13400	26460	26513	27	10
NC_002486.ref	NC_010807.alt2	63.8889	36	21918	21953	36956	37017	23	13
NC_002486.ref	NC_010807.alt2	62.8571	35	22651	22685	4725	4663	22	13
NC_025457.alt1	NC_002486.ref	61.1765	85	15612	15696	23472	23596	52	33
NC_025457.alt1	NC_002486.ref	53.6585	82	18806	18887	18295	18398	44	38
NC_025457.alt1	NC_002486.ref	51.4286	70	39688	39757	21566	21481	36	34
NC_025457.alt1	NC_002486.ref	61.7647	68	34824	34891	29362	29265	42	26
NC_025457.alt1	NC_002486.ref	58.4615	65	566	630	39253	39168	38	27
NC_025457.alt1	NC_002486.ref	60.9375	64	4470	4533	16682	16556	39	25
NC_025457.alt1	NC_002486.ref	53.2258	62	30931	30992	6409	6499	33	29
NC_025457.alt1	NC_002486.ref	53.2258	62	31325	31386	19590	19541	33	29
NC_025457.alt1	NC_002486.ref	40.3509	57	28967	29023	23424	23470	23	34
NC_025457.alt1	NC_002486.ref	58.9286	56	5239	5294	3547	3484	33	23
NC_025457.alt1	NC_002486.ref	58.9286	56	16503	16558	15073	15144	33	23
NC_025457.alt1	NC_002486.ref	53.5714	56	37653	37708	8120	8068	30	26
NC_025457.alt1	NC_002486.ref	56.3636	55	3265	3319	30863	30789	31	24
NC_025457.alt1	NC_002486.ref	66.6667	54	10010	10063	31361	31452	36	18
NC_025457.alt1	NC_002486.ref	57.6923	52	14834	14885	2199	2111	30	22
NC_025457.alt1	NC_002486.ref	65.3846	52	17627	17678	26419	26509	34	18
NC_025457.alt1	NC_002486.ref	67.3077	52	32829	32880	8798	8683	35	17
NC_025457.alt1	NC_002486.ref	56.8627	51	23140	23190	43436	43390	29	22
NC_025457.alt1	NC_002486.ref	37.2549	51	33334	33384	17903	17946	19	32
NC_025457.alt1	NC_002486.ref	48	50	40663	40712	37427	37469	24	26
NC_025457.alt1	NC_002486.ref	69.3878	49	2097	2145	34767	34821	34	15
NC_025457.alt1	NC_002486.ref	59.1837	49	6837	6885	36926	36989	29	20
NC_025457.alt1	NC_002486.ref	59.1837	49	16097	16145	31253	31319	29	20
NC_025457.alt1	NC_002486.ref	61.2245	49	17228	17276	20185	20263	30	19
NC_025457.alt1	NC_002486.ref	5e+01	48	2186	2233	7765	7805	24	24
NC_025457.alt1	NC_002486.ref	61.7021	47	12691	12737	13727	13793	29	18
NC_025457.alt1	NC_002486.ref	59.5745	47	37526	37572	43534	43450	28	19
NC_025457.alt1	NC_002486.ref	51.1628	43	2323	2365	29328	29363	22	21
NC_025457.alt1	NC_002486.ref	64.2857	42	7856	7897	19211	19266	27	15
NC_025457.alt1	NC_002486.ref	57.1429	42	21492	21533	2925	2857	24	18
NC_025457.alt1	NC_002486.ref	66.6667	39	30364	30402	18071	18009	26	13
NC_025457.alt1	NC_002486.ref	71.0526	38	23482	23519	42978	43036	27	11
NC_025457.alt1	NC_002486.ref	77.7778	36	3659	3694	10286	10357	28	8
NC_025457.alt1	NC_005091.ref	53.7313	67	2534	2600	29671	29609	36	31
NC_025457.alt1	NC_005091.ref	55.9322	59	6554	6612	8955	9030	33	26
NC_025457.alt1	NC_005091.ref	55.1724	58	20550	20607	49622	49674	32	26
NC_025457.alt1	NC_005091.ref	5e+01	56	2821	2876	6313	6393	28	28
NC_025457.alt1	NC_005091.ref	44.6429	56	17111	17166	9183	9135	25	31
NC_025457.alt1	NC_005091.ref	54.9020	51	7333	7383	4912	4976	28	23
NC_025457.alt1	NC_005091.ref	56	50	8648	8697	4400	4363	28	22
NC_025457.alt1	NC_005091.ref	57.1429	49	7694	7742	2575	2632	28	21
NC_025457.alt1	NC_005091.ref	54.1667	48	3253	3300	49400	49325	26	22
NC_025457.alt1	NC_005091.ref	58.3333	48	12350	12397	49431	49388	28	20
NC_025457.alt1	NC_005091.ref	69.5652	46	30157	30202	41376	41348	32	14
NC_025457.alt1	NC_005091.ref	56.0976	41	22859	22899	29049	29002	23	18
NC_025457.alt1	NC_005091.ref	70.7317	41	40691	40731	54245	54302	29	12
NC_025457.alt1	NC_005091.ref	62.5	40	12949	12988	11787	11759	25	15
NC_025457.alt1	NC_005091.ref	62.5	40	13098	13137	11787	11759	25	15
NC_025457.alt1	NC_005091.ref	72.5	40	38522	38561	32449	32398	29	11
NC_025457.alt1	NC_005091.ref	66.6667	39	359	397	47789	47857	26	13
NC_025457.alt1	NC_005091.ref	66.6667	39	15424	15462	39820	39763	26	13
NC_025457.alt1	NC_005091.ref	69.2308	39	30118	30156	21349	21414	27	12
NC_025457.alt1	NC_005091.ref	65.7895	38	16685	16722	14795	14724	25	13
NC_025457.alt1	NC_005091.ref	64.8649	37	34072	34108	2170	2129	24	13
NC_025457.alt1	NC_005091.ref	82.8571	35	18232	18266	20434	20470	29	6
NC_002486.ref	NC_010807.ref	54.3478	92	8722	8813	28243	28370	50	42
NC_002486.ref	NC_010807.ref	48.8095	84	35215	35298	16165	16228	41	43
NC_002486.ref	NC_010807.ref	43.5897	78	35765	35842	18444	18509	34	44
NC_002486.ref	NC_010807.ref	54.1667	72	6114	6185	38198	38133	39	33
NC_002486.ref	NC_010807.ref	55.8824	68	39350	39417	28691	28770	38	30
NC_002486.ref	NC_010807.ref	52.3077	65	6414	6478	34843	34900	34	31
NC_002486.ref	NC_010807.ref	42.1875	64	26987	27050	17863	17914	27	37
NC_002486.ref	NC_010807.ref	58.7302	63	41139	41201	21473	21567	37	26
NC_002486.ref	NC_010807.ref	55.7377	61	5984	6044	37512	37437	34	27
NC_002486.ref	NC_010807.ref	49.1525	59	3133	3191	15253	15202	29	30
NC_002486.ref	NC_010807.ref	47.3684	57	25678	25734	10511	10606	27	30
NC_002486.ref	NC_010807.ref	55.3571	56	1028	1083	18694	18627	31	25
NC_002486.ref	NC_010807.ref	58.4906	53	20899	20951	9910	9839	31	22
NC_002486.ref	NC_010807.ref	57.6923	52	19907	19958	7181	7270	30	22
NC_002486.ref	NC_010807.ref	53.8462	52	38145	38196	27802	27844	28	24
NC_002486.ref	NC_010807.ref	57.1429	49	38581	38629	33115	33159	28	21
NC_002486.ref	NC_010807.ref	58.3333	48	10506	10553	23450	23488	28	20
NC_002486.ref	NC_010807.ref	58.3333	48	35033	35080	15376	15342	28	20
NC_002486.ref	NC_010807.ref	73.9130	46	18451	18496	29196	29280	34	12
NC_002486.ref	NC_010807.ref	67.3913	46	31870	31915	17821	17740	31	15
NC_002486.ref	NC_010807.ref	67.3913	46	41375	41420	7074	7015	31	15
NC_002486.ref	NC_010807.ref	65.9091	44	8372	8415	5230	5163	29	15
NC_002486.ref	NC_010807.ref	58.5366	41	23542	23582	22805	22742	24	17
NC_002486.ref	NC_010807.ref	68.2927	41	28382	28422	35674	35731	28	13
NC_002486.ref	NC_010807.ref	55.2632	38	9078	9115	24901	24940	21	17
NC_002486.ref	NC_010807.ref	72.9730	37	13364	13400	25427	25480	27	10
NC_002486.ref	NC_010807.ref	77.1429	35	16868	16902	15646	15696	27	8
NC_002486.ref	NC_010807.ref	62.8571	35	22651	22685	4447	4385	22	13
NC_002486.alt	NC_025457.alt2	54.1667	96	37785	37880	44425	44347	52	44
NC_002486.alt	NC_025457.alt2	59.5238	84	9752	9835	2167	2074	50	34
NC_002486.alt	NC_025457.alt2	57.8125	64	31834	31897	4976	4925	37	27
NC_002486.alt	NC_025457.alt2	45.1613	62	29411	29472	6375	6427	28	34
NC_002486.alt	NC_025457.alt2	51.6667	60	13089	13148	30944	30985	31	29
NC_002486.alt	NC_025457.alt2	55	60	29695	29754	22615	22670	33	27
NC_002486.alt	NC_025457.alt2	56.6667	60	41006	41065	23178	23228	34	26
NC_002486.alt	NC_025457.alt2	48.2143	56	2175	2230	57717	57673	27	29
NC_002486.alt	NC_025457.alt2	42.8571	56	38182	38237	27591	27633	24	32
NC_002486.alt	NC_025457.alt2	69.0909	55	27436	27490	63301	63213	38	17
NC_002486.alt	NC_025457.alt2	56.6038	53	16118	16170	37514	37582	30	23
NC_002486.alt	NC_025457.alt2	54.7170	53	18030	18082	31369	31298	29	24
NC_002486.alt	NC_025457.alt2	63.4615	52	5941	5992	2136	2068	33	19
NC_002486.alt	NC_025457.alt2	44.2308	52	17383	17434	23884	23923	23	29
NC_002486.alt	NC_025457.alt2	5e+01	52	20302	20353	40373	40331	26	26
NC_002486.alt	NC_025457.alt2	49.0196	51	25008	25058	17312	17354	25	26
NC_002486.alt	NC_025457.alt2	56.8627	51	37091	37141	60495	60549	29	22
NC_002486.alt	NC_025457.alt2	64	50	16908	16957	52061	51991	32	18
NC_002486.alt	NC_025457.alt2	55.1020	49	6366	6414	9558	9623	27	22
NC_002486.alt	NC_025457.alt2	59.1837	49	9129	9177	2015	2072	29	20
NC_002486.alt	NC_025457.alt2	63.2653	49	22159	22207	40282	40352	31	18
NC_002486.alt	NC_025457.alt2	56.25	48	3343	3390	42630	42680	27	21
NC_002486.alt	NC_025457.alt2	70.2128	47	29887	29933	4446	4422	33	14
NC_002486.alt	NC_025457.alt2	44.6809	47	30085	30131	43702	43740	21	26
NC_002486.alt	NC_025457.alt2	63.0435	46	34749	34794	22180	22133	29	17
NC_002486.alt	NC_025457.alt2	63.0435	46	44743	44788	45055	45109	29	17
NC_002486.alt	NC_025457.alt2	65.9091	44	2129	2172	261	189	29	15
NC_002486.alt	NC_025457.alt2	69.7674	43	31008	31050	14822	14854	30	13
NC_002486.alt	NC_025457.alt2	59.5238	42	7018	7059	48919	48950	25	17
NC_002486.alt	NC_025457.alt2	54.7619	42	30418	30459	60506	60477	23	19
NC_002486.alt	NC_025457.alt2	56.0976	41	26300	26340	2679	2712	23	18
NC_002486.alt	NC_025457.alt2	65.8537	41	40402	40442	35475	35581	27	14
NC_002486.alt	NC_025457.alt2	65	40	29276	29315	18441	18519	26	14
NC_002486.alt	NC_025457.alt2	58.9744	39	22610	22648	11856	11900	23	16
NC_002486.alt	NC_025457.alt2	69.2308	39	24308	24346	4708	4642	27	12
NC_002486.alt	NC_025457.alt2	55.2632	38	2740	2777	47194	47161	21	17
NC_002486.alt	NC_025457.alt2	78.3784	37	12002	12038	34361	34297	29	8
NC_002486.alt	NC_025457.alt2	75.6757	37	24096	24132	42019	42061	28	9
NC_002486.alt	NC_025457.alt2	77.7778	36	32742	32777	3650	3609	28	8
NC_002486.alt	NC_025457.alt2	66.6667	36	34618	34653	821	875	24	12
NC_002486.alt	NC_025457.alt2	71.4286	35	6178	6212	45738	45771	25	10
NC_002486.alt	NC_025457.alt2	68.5714	35	7226	7260	33849	33806	24	11
NC_002486.alt	NC_025457.alt2	62.8571	35	14753	14787	34315	34346	22	13
NC_002486.alt	NC_025457.alt2	65.7143	35	33661	33695	18222	18188	23	12
NC_002486.alt	NC_025457.alt2	71.4286	35	39854	39888	50309	50380	25	10
NC_002486.alt	NC_025457.alt2	74.2857	35	44200	44234	23229	23298	26	9
NC_002486.ref	NC_010807.alt3	54.3478	92	8722	8813	3021	3148	50	42
NC_002486.ref	NC_010807.alt3	48.8095	84	35215	35298	16418	16477	41	43
NC_002486.ref	NC_010807.alt3	43.5897	78	35765	35842	19091	19156	34	44
NC_002486.ref	NC_010807.alt3	67.9487	78	44018	44095	11903	11811	53	25
NC_002486.ref	NC_010807.alt3	54.1667	72	6114	6185	39274	39209	39	33
NC_002486.ref	NC_010807.alt3	55.8824	68	39350	39417	28668	28747	38	30
NC_002486.ref	NC_010807.alt3	52.3077	65	6414	6478	35535	35592	34	31
NC_002486.ref	NC_010807.alt3	42.1875	64	26987	27050	18300	18351	27	37
NC_002486.ref	NC_010807.alt3	58.7302	63	41139	41201	21794	21888	37	26
NC_002486.ref	NC_010807.alt3	55.7377	61	5984	6044	38588	38513	34	27
NC_002486.ref	NC_010807.alt3	49.1525	59	3133	3191	15506	15455	29	30
NC_002486.ref	NC_010807.alt3	47.3684	57	25678	25734	10727	10822	27	30
NC_002486.ref	NC_010807.alt3	55.3571	56	1028	1083	19341	19274	31	25
NC_002486.ref	NC_010807.alt3	62.9630	54	31870	31923	18258	18169	34	20
NC_002486.ref	NC_010807.alt3	58.4906	53	20899	20951	10126	10055	31	22
NC_002486.ref	NC_010807.alt3	57.6923	52	19907	19958	7471	7560	30	22
NC_002486.ref	NC_010807.alt3	53.8462	52	38145	38196	27941	27983	28	24
NC_002486.ref	NC_010807.alt3	57.1429	49	38581	38629	33598	33642	28	21
NC_002486.ref	NC_010807.alt3	58.3333	48	10506	10553	23975	24013	28	20
NC_002486.ref	NC_010807.alt3	58.3333	48	35033	35080	15629	15595	28	20
NC_002486.ref	NC_010807.alt3	73.9130	46	18451	18496	29173	29257	34	12
NC_002486.ref	NC_010807.alt3	67.3913	46	41375	41420	7364	7305	31	15
NC_002486.ref	NC_010807.alt3	65.9091	44	8372	8415	5667	5600	29	15
NC_002486.ref	NC_010807.alt3	58.5366	41	23542	23582	23235	23172	24	17
NC_002486.ref	NC_010807.alt3	55.2632	38	9078	9115	3551	3512	21	17
NC_002486.ref	NC_010807.alt3	72.9730	37	13364	13400	25773	25826	27	10
NC_002486.ref	NC_010807.alt3	77.1429	35	16868	16902	15899	15949	27	8
NC_002486.ref	NC_010807.alt3	62.8571	35	22651	22685	37178	37240	22	13
NC_025457.alt1	NC_005091.alt1	58.3333	72	23633	23704	31022	30936	42	30
NC_025457.alt1	NC_005091.alt1	56.3380	71	34894	34964	57139	57031	40	31
NC_025457.alt1	NC_005091.alt1	54.4118	68	2533	2600	29585	29522	37	31
NC_025457.alt1	NC_005091.alt1	49.1525	59	39272	39330	38818	38873	29	30
NC_025457.alt1	NC_005091.alt1	55.1724	58	20550	20607	49871	49923	32	26
NC_025457.alt1	NC_005091.alt1	51.7857	56	2821	2876	6313	6393	29	27
NC_025457.alt1	NC_005091.alt1	55.5556	54	6140	6193	24275	24227	30	24
NC_025457.alt1	NC_005091.alt1	62	50	13454	13503	29915	29961	31	19
NC_025457.alt1	NC_005091.alt1	56.25	48	12350	12397	49680	49637	27	21
NC_025457.alt1	NC_005091.alt1	59.5745	47	29659	29705	41820	41762	28	19
NC_025457.alt1	NC_005091.alt1	70.2128	47	30156	30202	41683	41654	33	14
NC_025457.alt1	NC_005091.alt1	6e+01	45	28052	28096	3447	3415	27	18
NC_025457.alt1	NC_005091.alt1	59.5238	42	17054	17095	18279	18326	25	17
NC_025457.alt1	NC_005091.alt1	56.0976	41	22859	22899	28962	28915	23	18
NC_025457.alt1	NC_005091.alt1	62.5	40	12949	12988	11787	11759	25	15
NC_025457.alt1	NC_005091.alt1	62.5	40	13098	13137	11787	11759	25	15
NC_025457.alt1	NC_005091.alt1	72.5	40	38522	38561	32658	32709	29	11
NC_025457.alt1	NC_005091.alt1	66.6667	39	359	397	47951	48019	26	13
NC_025457.alt1	NC_005091.alt1	65.7895	38	16685	16722	14795	14724	25	13
NC_025457.alt1	NC_005091.alt1	64.8649	37	34072	34108	2168	2209	24	13
NC_025457.alt1	NC_005091.alt1	77.1429	35	18232	18266	20434	20470	27	8
NC_025457.ref	NC_010807.alt1	50.3759	133	29179	29311	19578	19816	67	66
NC_025457.ref	NC_010807.alt1	4e+01	100	16130	16229	11307	11213	40	60
NC_025457.ref	NC_010807.alt1	40.625	96	38527	38622	26318	26414	39	57
NC_025457.ref	NC_010807.alt1	58.75	80	30342	30421	10804	10949	47	33
NC_025457.ref	NC_010807.alt1	48.0519	77	31897	31973	5848	5943	37	40
NC_025457.ref	NC_010807.alt1	54.5455	66	4490	4555	26271	26180	36	30
NC_025457.ref	NC_010807.alt1	53.9683	63	42054	42116	3082	2997	34	29
NC_025457.ref	NC_010807.alt1	53.2258	62	3593	3654	10701	10808	33	29
NC_025457.ref	NC_010807.alt1	5e+01	58	8762	8819	20151	20244	29	29
NC_025457.ref	NC_010807.alt1	46.5517	58	20562	20619	28879	28929	27	31
NC_025457.ref	NC_010807.alt1	53.5714	56	22756	22811	28279	28349	30	26
NC_025457.ref	NC_010807.alt1	41.8182	55	33032	33086	16971	17014	23	32
NC_025457.ref	NC_010807.alt1	47.2727	55	34119	34173	21882	21793	26	29
NC_025457.ref	NC_010807.alt1	62.9630	54	11884	11937	37482	37532	34	20
NC_025457.ref	NC_010807.alt1	60.7843	51	20867	20917	4262	4344	31	20
NC_025457.ref	NC_010807.alt1	56	50	3860	3909	18608	18687	28	22
NC_025457.ref	NC_010807.alt1	66.6667	48	34483	34530	29778	29834	32	16
NC_025457.ref	NC_010807.alt1	61.7021	47	32067	32113	19067	19136	29	18
NC_025457.ref	NC_010807.alt1	63.0435	46	28508	28553	17099	17132	29	17
NC_025457.ref	NC_010807.alt1	6e+01	45	16009	16053	20982	21058	27	18
NC_025457.ref	NC_010807.alt1	55.5556	45	18382	18426	18524	18561	25	20
NC_025457.ref	NC_010807.alt1	66.6667	45	24668	24712	23944	23976	30	15
NC_025457.ref	NC_010807.alt1	76.7442	43	17812	17854	393	434	33	10
NC_025457.ref	NC_010807.alt1	58.5366	41	4838	4878	7528	7578	24	17
NC_025457.ref	NC_010807.alt1	7e+01	40	6856	6895	16171	16097	28	12
NC_025457.ref	NC_010807.alt1	62.5	40	24471	24510	3570	3611	25	15
NC_025457.ref	NC_010807.alt1	6e+01	40	42486	42525	18508	18540	24	16
NC_025457.ref	NC_010807.alt1	69.2308	39	7407	7445	13945	14018	27	12
NC_025457.ref	NC_010807.alt1	57.8947	38	39008	39045	36477	36447	22	16
NC_025457.alt1	NC_005091.alt2	40.6780	59	6273	6331	12488	12536	24	35
NC_025457.alt1	NC_005091.alt2	55.9322	59	10565	10623	15578	15665	33	26
NC_025457.alt1	NC_005091.alt2	44.6429	56	17111	17166	10053	10005	25	31
NC_025457.alt1	NC_005091.alt2	41.1765	51	12477	12527	53813	53770	21	30
NC_025457.alt1	NC_005091.alt2	56	50	8648	8697	4932	4895	28	22
NC_025457.alt1	NC_005091.alt2	58.3333	48	12350	12397	54350	54307	28	20
NC_025457.alt1	NC_005091.alt2	58.3333	48	27029	27076	63401	63357	28	20
NC_025457.alt1	NC_005091.alt2	65.9574	47	21594	21640	19103	19165	31	16
NC_025457.alt1	NC_005091.alt2	68.0851	47	30156	30202	45417	45388	32	15
NC_025457.alt1	NC_005091.alt2	46.8085	47	32654	32700	23612	23577	22	25
NC_025457.alt1	NC_005091.alt2	54.3478	46	11008	11053	9423	9492	25	21
NC_025457.alt1	NC_005091.alt2	64.4444	45	27876	27920	9785	9839	29	16
NC_025457.alt1	NC_005091.alt2	70.7317	41	40691	40731	60174	60231	29	12
NC_025457.alt1	NC_005091.alt2	66.6667	39	6196	6234	18028	18091	26	13
NC_025457.alt1	NC_005091.alt2	64.8649	37	34072	34108	2292	2251	24	13
NC_010807.alt2	NC_002486.alt	56.9620	79	29346	29424	2465	2547	45	34
NC_010807.alt2	NC_002486.alt	41.1765	68	38188	38255	29989	30045	28	40
NC_010807.alt2	NC_002486.alt	50.7463	67	35099	35165	7230	7308	34	33
NC_010807.alt2	NC_002486.alt	53.2258	62	4454	4515	28751	28666	33	29
NC_010807.alt2	NC_002486.alt	54.8387	62	28271	28332	43842	43790	34	28
NC_010807.alt2	NC_002486.alt	44.8276	58	25533	25590	24927	24975	26	32
NC_010807.alt2	NC_002486.alt	56.8966	58	36410	36467	36838	36909	33	25
NC_010807.alt2	NC_002486.alt	66.0714	56	13748	13803	25560	25641	37	19
NC_010807.alt2	NC_002486.alt	48.0769	52	21623	21674	6147	6188	25	27
NC_010807.alt2	NC_002486.alt	5e+01	52	30321	30372	27186	27147	26	26
NC_010807.alt2	NC_002486.alt	62.5	48	14562	14609	43666	43749	30	18
NC_010807.alt2	NC_002486.alt	66.6667	48	16607	16654	3685	3649	32	16
NC_010807.alt2	NC_002486.alt	66.6667	48	18807	18854	18650	18538	32	16
NC_010807.alt2	NC_002486.alt	40.4255	47	34291	34337	2607	2646	19	28
NC_010807.alt2	NC_002486.alt	65.2174	46	32517	32562	42613	42692	30	16
NC_010807.alt2	NC_002486.alt	66.6667	45	18863	18907	8496	8417	30	15
NC_010807.alt2	NC_002486.alt	66.6667	45	22130	22174	23804	23727	30	15
NC_010807.alt2	NC_002486.alt	67.4419	43	808	850	25177	25133	29	14
NC_010807.alt2	NC_002486.alt	47.6190	42	9998	10039	38285	38318	20	22
NC_010807.alt2	NC_002486.alt	6e+01	40	25934	25973	39502	39539	24	16
NC_010807.alt2	NC_002486.alt	58.9744	39	9156	9194	38288	38242	23	16
NC_010807.alt2	NC_002486.alt	71.7949	39	24483	24521	40930	40977	28	11
NC_010807.alt2	NC_002486.ref	56.9620	79	29346	29424	32889	32971	45	34
NC_010807.alt2	NC_002486.ref	41.1765	68	38188	38255	15648	15592	28	40
NC_010807.alt2	NC_002486.ref	50.7463	67	35099	35165	37654	37732	34	33
NC_010807.alt2	NC_002486.ref	53.2258	62	4454	4515	16886	16971	33	29
NC_010807.alt2	NC_002486.ref	54.8387	62	28271	28332	13418	13366	34	28
NC_010807.alt2	NC_002486.ref	56.8966	58	36410	36467	6414	6485	33	25
NC_010807.alt2	NC_002486.ref	66.0714	56	13748	13803	20077	19996	37	19
NC_010807.alt2	NC_002486.ref	48.0769	52	21623	21674	36571	36612	25	27
NC_010807.alt2	NC_002486.ref	5e+01	52	30321	30372	18451	18490	26	26
NC_010807.alt2	NC_002486.ref	62.5	48	14562	14609	13242	13325	30	18
NC_010807.alt2	NC_002486.ref	66.6667	48	16607	16654	34109	34073	32	16
NC_010807.alt2	NC_002486.ref	66.6667	48	18807	18854	26987	27099	32	16
NC_010807.alt2	NC_002486.ref	40.4255	47	34291	34337	33031	33070	19	28
NC_010807.alt2	NC_002486.ref	65.2174	46	32517	32562	12189	12268	30	16
NC_010807.alt2	NC_002486.ref	66.6667	45	18863	18907	38920	38841	30	15
NC_010807.alt2	NC_002486.ref	66.6667	45	22130	22174	21833	21910	30	15
NC_010807.alt2	NC_002486.ref	67.4419	43	808	850	20460	20504	29	14
NC_010807.alt2	NC_002486.ref	47.6190	42	9998	10039	7861	7894	20	22
NC_010807.alt2	NC_002486.ref	6e+01	40	25934	25973	9078	9115	24	16
NC_010807.alt2	NC_002486.ref	58.9744	39	9156	9194	7864	7818	23	16
NC_010807.alt2	NC_002486.ref	71.7949	39	24483	24521	10506	10553	28	11
NC_010807.alt2	NC_025457.ref	55.5556	72	34428	34499	37093	37011	40	32
NC_010807.alt2	NC_025457.ref	49.2063	63	13307	13369	33447	33513	31	32
NC_010807.alt2	NC_025457.ref	55.5556	63	17784	17846	37857	37953	35	28
NC_010807.alt2	NC_025457.ref	53.3333	60	23069	23128	28085	28165	32	28
NC_010807.alt2	NC_025457.ref	60.3448	58	9453	9510	18932	19020	35	23
NC_010807.alt2	NC_025457.ref	67.2414	58	11772	11829	17573	17683	39	19
NC_010807.alt2	NC_025457.ref	56.8966	58	14094	14151	26948	27023	33	25
NC_010807.alt2	NC_025457.ref	42.1053	57	12411	12467	21990	21941	24	33
NC_010807.alt2	NC_025457.ref	56.3636	55	30905	30959	34485	34530	31	24
NC_010807.alt2	NC_025457.ref	55.7692	52	10434	10485	4950	4883	29	23
NC_010807.alt2	NC_025457.ref	57.6923	52	32293	32344	2464	2411	30	22
NC_010807.alt2	NC_025457.ref	52.9412	51	32798	32848	25802	25855	27	24
NC_010807.alt2	NC_025457.ref	58.8235	51	39222	39272	11884	11937	30	21
NC_010807.alt2	NC_025457.ref	61.2245	49	38958	39006	17127	17069	30	19
NC_010807.alt2	NC_025457.ref	72.9167	48	21519	21566	12743	12798	35	13
NC_010807.alt2	NC_025457.ref	56.25	48	25693	25740	35479	35441	27	21
NC_010807.alt2	NC_025457.ref	60.4167	48	29060	29107	4066	4010	29	19
NC_010807.alt2	NC_025457.ref	55.5556	45	4896	4940	33858	33894	25	20
NC_010807.alt2	NC_025457.ref	66.6667	45	10504	10548	6710	6788	30	15
NC_010807.alt2	NC_025457.ref	68.8889	45	20809	20853	24112	24148	31	14
NC_010807.alt2	NC_025457.ref	64.4444	45	27150	27194	30934	30893	29	16
NC_010807.alt2	NC_025457.ref	62.7907	43	24680	24722	29055	29113	27	16
NC_010807.alt2	NC_025457.ref	73.8095	42	786	827	17812	17854	31	11
NC_010807.alt2	NC_025457.ref	66.6667	42	37981	38022	20793	20752	28	14
NC_010807.alt2	NC_025457.ref	67.5	40	5811	5850	10479	10529	27	13
NC_010807.alt2	NC_025457.ref	64.1026	39	19925	19963	34344	34406	25	14
NC_010807.alt2	NC_025457.ref	66.6667	39	26078	26116	41327	41387	26	13
NC_010807.alt2	NC_025457.ref	55.2632	38	1811	1848	23227	23262	21	17
NC_010807.alt2	NC_025457.ref	62.1622	37	20685	20721	40626	40662	23	14
NC_010807.alt2	NC_025457.ref	75	36	5222	5257	20785	20820	27	9
NC_010807.alt2	NC_025457.ref	69.4444	36	7933	7968	9865	9826	25	11
NC_010807.alt2	NC_025457.ref	69.4444	36	10166	10201	23927	23956	25	11
NC_010807.alt2	NC_025457.ref	71.4286	35	19786	19820	12874	12918	25	10
NC_025457.ref	NC_010807.alt2	39	100	16130	16229	12745	12651	39	61
NC_025457.ref	NC_010807.alt2	6e+01	80	30342	30421	12242	12387	48	32
NC_025457.ref	NC_010807.alt2	54.5455	66	4490	4555	27304	27213	36	30
NC_025457.ref	NC_010807.alt2	57.8125	64	22756	22819	29312	29405	37	27
NC_025457.ref	NC_010807.alt2	52.3810	63	42054	42116	3986	3901	33	30
NC_025457.ref	NC_010807.alt2	49.1803	61	41327	41387	26078	26129	30	31
NC_025457.ref	NC_010807.alt2	5e+01	58	8762	8819	21095	21188	29	29
NC_025457.ref	NC_010807.alt2	46.5517	58	20562	20619	29912	29962	27	31
NC_025457.ref	NC_010807.alt2	56.1404	57	26094	26150	35529	35624	32	25
NC_025457.ref	NC_010807.alt2	60.7143	56	41684	41739	21510	21444	34	22
NC_025457.ref	NC_010807.alt2	41.8182	55	33032	33086	18031	18074	23	32
NC_025457.ref	NC_010807.alt2	50.9091	55	38527	38581	27351	27413	28	27
NC_025457.ref	NC_010807.alt2	62.9630	54	11884	11937	39222	39272	34	20
NC_025457.ref	NC_010807.alt2	60.7843	51	20867	20917	5166	5248	31	20
NC_025457.ref	NC_010807.alt2	68	50	3860	3909	19668	19747	34	16
NC_025457.ref	NC_010807.alt2	54	50	21980	22029	12421	12363	27	23
NC_025457.ref	NC_010807.alt2	51.0638	47	13834	13880	1125	1160	24	23
NC_025457.ref	NC_010807.alt2	67.3913	46	15618	15663	1117	1233	31	15
NC_025457.ref	NC_010807.alt2	63.0435	46	28508	28553	18159	18192	29	17
NC_025457.ref	NC_010807.alt2	65.2174	46	34485	34530	30905	30959	30	16
NC_025457.ref	NC_010807.alt2	55.5556	45	18382	18426	19584	19621	25	20
NC_025457.ref	NC_010807.alt2	69.7674	43	939	981	8269	8327	30	13
NC_025457.ref	NC_010807.alt2	60.4651	43	4279	4321	25402	25363	26	17
NC_025457.ref	NC_010807.alt2	74.4186	43	17812	17854	786	827	32	11
NC_025457.ref	NC_010807.alt2	66.6667	42	20752	20793	38022	37981	28	14
NC_025457.ref	NC_010807.alt2	56.0976	41	4838	4878	8850	8900	23	18
NC_025457.ref	NC_010807.alt2	63.4146	41	19634	19674	37878	37928	26	15
NC_025457.ref	NC_010807.alt2	68.2927	41	34717	34757	18936	18881	28	13
NC_025457.ref	NC_010807.alt2	62.5	40	24471	24510	4474	4515	25	15
NC_025457.ref	NC_010807.alt2	6e+01	40	42486	42525	19568	19600	24	16
NC_025457.ref	NC_010807.alt2	69.2308	39	7407	7445	15296	15369	27	12
NC_025457.ref	NC_010807.alt2	57.8947	38	35373	35410	25836	25912	22	16
NC_025457.ref	NC_010807.alt2	57.8947	38	39008	39045	38217	38187	22	16
NC_025457.ref	NC_010807.ref	50.3759	133	29179	29311	19578	19816	67	66
NC_025457.ref	NC_010807.ref	39	100	16130	16229	12049	11955	39	61
NC_025457.ref	NC_010807.ref	40.625	96	38527	38622	26318	26414	39	57
NC_025457.ref	NC_010807.ref	58.75	80	30342	30421	11546	11691	47	33
NC_025457.ref	NC_010807.ref	48.0519	77	31897	31973	6474	6569	37	40
NC_025457.ref	NC_010807.ref	54.5455	66	4490	4555	26271	26180	36	30
NC_025457.ref	NC_010807.ref	53.9683	63	42054	42116	3708	3623	34	29
NC_025457.ref	NC_010807.ref	53.2258	62	3593	3654	11443	11550	33	29
NC_025457.ref	NC_010807.ref	5e+01	58	8762	8819	20151	20244	29	29
NC_025457.ref	NC_010807.ref	46.5517	58	20562	20619	28879	28929	27	31
NC_025457.ref	NC_010807.ref	53.5714	56	22756	22811	28279	28349	30	26
NC_025457.ref	NC_010807.ref	41.8182	55	33032	33086	17087	17130	23	32
NC_025457.ref	NC_010807.ref	47.2727	55	34119	34173	21882	21793	26	29
NC_025457.ref	NC_010807.ref	62.9630	54	11884	11937	37482	37532	34	20
NC_025457.ref	NC_010807.ref	60.7843	51	20867	20917	4888	4970	31	20
NC_025457.ref	NC_010807.ref	56	50	3860	3909	18724	18803	28	22
NC_025457.ref	NC_010807.ref	66.6667	48	34483	34530	29778	29834	32	16
NC_025457.ref	NC_010807.ref	48.9362	47	13834	13880	1016	1051	23	24
NC_025457.ref	NC_010807.ref	61.7021	47	32067	32113	19183	19252	29	18
NC_025457.ref	NC_010807.ref	67.3913	46	15618	15663	1008	1124	31	15
NC_025457.ref	NC_010807.ref	63.0435	46	28508	28553	17215	17248	29	17
NC_025457.ref	NC_010807.ref	6e+01	45	16009	16053	20982	21058	27	18
NC_025457.ref	NC_010807.ref	55.5556	45	18382	18426	18640	18677	25	20
NC_025457.ref	NC_010807.ref	66.6667	45	24668	24712	23944	23976	30	15
NC_025457.ref	NC_010807.ref	76.7442	43	17812	17854	677	718	33	10
NC_025457.ref	NC_010807.ref	58.5366	41	4838	4878	8154	8204	24	17
NC_025457.ref	NC_010807.ref	65.8537	41	34717	34757	17992	17937	27	14
NC_025457.ref	NC_010807.ref	7e+01	40	6856	6895	16287	16213	28	12
NC_025457.ref	NC_010807.ref	62.5	40	24471	24510	4196	4237	25	15
NC_025457.ref	NC_010807.ref	6e+01	40	42486	42525	18624	18656	24	16
NC_025457.ref	NC_010807.ref	69.2308	39	7407	7445	14507	14580	27	12
NC_025457.ref	NC_010807.ref	57.8947	38	39008	39045	36477	36447	22	16
NC_010807.alt2	NC_005091.ref	51.7241	87	17566	17652	20995	21094	45	42
NC_010807.alt2	NC_005091.ref	52.8736	87	20840	20926	30318	30446	46	41
NC_010807.alt2	NC_005091.ref	61.8421	76	29575	29650	17715	17812	47	29
NC_010807.alt2	NC_005091.ref	49.3333	75	15891	15965	54889	54951	37	38
NC_010807.alt2	NC_005091.ref	58.4615	65	28771	28835	31486	31433	38	27
NC_010807.alt2	NC_005091.ref	39.0625	64	25380	25443	50075	50020	25	39
NC_010807.alt2	NC_005091.ref	59.6774	62	21899	21960	48484	48411	37	25
NC_010807.alt2	NC_005091.ref	53.3333	60	3307	3366	55307	55399	32	28
NC_010807.alt2	NC_005091.ref	55	60	9771	9830	20588	20545	33	27
NC_010807.alt2	NC_005091.ref	46.6667	60	38619	38678	40013	40100	28	32
NC_010807.alt2	NC_005091.ref	55.1724	58	6674	6731	26171	26251	32	26
NC_010807.alt2	NC_005091.ref	43.1034	58	9142	9199	46971	47017	25	33
NC_010807.alt2	NC_005091.ref	5e+01	58	10654	10711	51901	51851	29	29
NC_010807.alt2	NC_005091.ref	46.5517	58	28273	28330	35692	35632	27	31
NC_010807.alt2	NC_005091.ref	38.5965	57	12535	12591	37525	37570	22	35
NC_010807.alt2	NC_005091.ref	50.8772	57	31266	31322	33320	33280	29	28
NC_010807.alt2	NC_005091.ref	41.8182	55	20561	20615	42608	42565	23	32
NC_010807.alt2	NC_005091.ref	62.9630	54	3883	3936	51521	51441	34	20
NC_010807.alt2	NC_005091.ref	66.6667	54	31818	31871	38152	38212	36	18
NC_010807.alt2	NC_005091.ref	5e+01	52	22968	23019	16680	16752	26	26
NC_010807.alt2	NC_005091.ref	61.2245	49	10724	10772	4343	4300	30	19
NC_010807.alt2	NC_005091.ref	53.0612	49	23040	23088	30089	30133	26	23
NC_010807.alt2	NC_005091.ref	64.5833	48	32982	33029	47085	47170	31	17
NC_010807.alt2	NC_005091.ref	57.4468	47	11506	11552	20261	20194	27	20
NC_010807.alt2	NC_005091.ref	55.3191	47	18054	18100	36721	36687	26	21
NC_010807.alt2	NC_005091.ref	62.2222	45	19447	19491	9129	9194	28	17
NC_010807.alt2	NC_005091.ref	68.1818	44	32462	32505	55654	55704	30	14
NC_010807.alt2	NC_005091.ref	56.8182	44	33047	33090	27791	27821	25	19
NC_010807.alt2	NC_005091.ref	66.6667	42	7255	7296	42608	42671	28	14
NC_010807.alt2	NC_005091.ref	76.1905	42	26013	26054	54619	54694	32	10
NC_010807.alt2	NC_005091.ref	62.5	40	1649	1688	6605	6561	25	15
NC_010807.alt2	NC_005091.ref	65	40	16599	16638	19770	19692	26	14
NC_010807.alt2	NC_005091.ref	65	40	36304	36343	2443	2365	26	14
NC_010807.alt2	NC_005091.ref	71.0526	38	3256	3293	44475	44530	27	11
NC_010807.alt2	NC_005091.ref	64.8649	37	11410	11446	17216	17181	24	13
NC_010807.alt2	NC_005091.ref	67.5676	37	29405	29441	32102	32066	25	12
NC_010807.alt2	NC_005091.ref	75	36	11922	11957	34805	34758	27	9
NC_010807.alt2	NC_005091.ref	66.6667	36	20368	20403	50324	50297	24	12
NC_010807.alt2	NC_005091.ref	71.4286	35	25123	25157	26910	26950	25	10
NC_002486.ref	NC_025457.alt1	59.0361	83	13934	14016	26159	26073	49	34
NC_002486.ref	NC_025457.alt1	63.2911	79	26940	27018	20182	20029	50	29
NC_002486.ref	NC_025457.alt1	5e+01	72	15073	15144	16503	16562	36	36
NC_002486.ref	NC_025457.alt1	54.9296	71	489	559	26811	26923	39	32
NC_002486.ref	NC_025457.alt1	56.9231	65	14390	14454	25344	25256	37	28
NC_002486.ref	NC_025457.alt1	6e+01	60	10370	10429	7727	7779	36	24
NC_002486.ref	NC_025457.alt1	56.6667	60	10582	10641	14729	14779	34	26
NC_002486.ref	NC_025457.alt1	57.6271	59	8876	8934	6515	6589	34	25
NC_002486.ref	NC_025457.alt1	42.3729	59	19032	19090	23914	23864	25	34
NC_002486.ref	NC_025457.alt1	58.6207	58	36868	36925	33337	33382	34	24
NC_002486.ref	NC_025457.alt1	64.2857	56	43095	43150	424	475	36	20
NC_002486.ref	NC_025457.alt1	52.7273	55	7533	7587	32100	32164	29	26
NC_002486.ref	NC_025457.alt1	52.7273	55	11426	11480	5646	5725	29	26
NC_002486.ref	NC_025457.alt1	50.9091	55	12674	12728	16076	16029	28	27
NC_002486.ref	NC_025457.alt1	6e+01	55	16966	17020	27916	27961	33	22
NC_002486.ref	NC_025457.alt1	54.5455	55	34613	34667	24693	24646	30	25
NC_002486.ref	NC_025457.alt1	54.5455	55	38842	38896	19875	19817	30	25
NC_002486.ref	NC_025457.alt1	52.7273	55	40176	40230	1449	1408	29	26
NC_002486.ref	NC_025457.alt1	83.3333	54	29921	29974	9598	9737	45	9
NC_002486.ref	NC_025457.alt1	52.8302	53	5133	5185	558	522	28	25
NC_002486.ref	NC_025457.alt1	61.5385	52	10191	10242	17993	18061	32	20
NC_002486.ref	NC_025457.alt1	45.0980	51	18075	18125	32259	32216	23	28
NC_002486.ref	NC_025457.alt1	69.3878	49	17549	17597	40898	40985	34	15
NC_002486.ref	NC_025457.alt1	63.2653	49	41088	41136	11496	11563	31	18
NC_002486.ref	NC_025457.alt1	66.6667	48	1656	1703	31456	31527	32	16
NC_002486.ref	NC_025457.alt1	60.4167	48	19211	19258	7856	7926	29	19
NC_002486.ref	NC_025457.alt1	60.4167	48	21909	21956	26427	26510	29	19
NC_002486.ref	NC_025457.alt1	64.4444	45	5534	5578	15649	15613	29	16
NC_002486.ref	NC_025457.alt1	65.9091	44	30767	30810	16594	16623	29	15
NC_002486.ref	NC_025457.alt1	65.9091	44	39719	39762	7012	6939	29	15
NC_002486.ref	NC_025457.alt1	60.4651	43	20739	20781	33860	33926	26	17
NC_002486.ref	NC_025457.alt1	66.6667	42	10286	10327	3659	3708	28	14
NC_002486.ref	NC_025457.alt1	66.6667	42	11274	11315	34241	34305	28	14
NC_002486.ref	NC_025457.alt1	66.6667	42	26414	26455	35506	35565	28	14
NC_002486.ref	NC_025457.alt1	64.2857	42	42555	42596	32634	32603	27	15
NC_002486.ref	NC_025457.alt1	51.2195	41	6723	6763	14942	14974	21	20
NC_002486.ref	NC_025457.alt1	65.7895	38	19461	19498	6913	6947	25	13
NC_002486.ref	NC_025457.alt1	72.2222	36	7457	7492	20859	20803	26	10
NC_002486.ref	NC_025457.alt1	61.1111	36	7758	7793	16919	16958	22	14
NC_002486.ref	NC_025457.alt1	61.1111	36	41809	41844	34372	34298	22	14
NC_025457.ref	NC_010807.alt3	39	100	16130	16229	12265	12171	39	61
NC_025457.ref	NC_010807.alt3	45.8333	96	41021	41116	19069	18965	44	52
NC_025457.ref	NC_010807.alt3	50.5618	89	14866	14954	24514	24424	45	44
NC_025457.ref	NC_010807.alt3	6e+01	80	30342	30421	11762	11907	48	32
NC_025457.ref	NC_010807.alt3	48.0519	77	31897	31973	6658	6753	37	40
NC_025457.ref	NC_010807.alt3	45.9459	74	24445	24518	38226	38279	34	40
NC_025457.ref	NC_010807.alt3	54.5455	66	4490	4555	26508	26417	36	30
NC_025457.ref	NC_010807.alt3	53.9683	63	42054	42116	4355	4270	34	29
NC_025457.ref	NC_010807.alt3	53.2258	62	3593	3654	11659	11766	33	29
NC_025457.ref	NC_010807.alt3	62.9032	62	29179	29240	19997	20091	39	23
NC_025457.ref	NC_010807.alt3	5e+01	58	8762	8819	20472	20565	29	29
NC_025457.ref	NC_010807.alt3	53.4483	58	10932	10989	345	275	31	27
NC_025457.ref	NC_010807.alt3	54.3860	57	35468	35524	25294	25210	31	26
NC_025457.ref	NC_010807.alt3	53.5714	56	22756	22811	3057	3127	30	26
NC_025457.ref	NC_010807.alt3	41.8182	55	33032	33086	17524	17567	23	32
NC_025457.ref	NC_010807.alt3	62.9630	54	11884	11937	38558	38608	34	20
NC_025457.ref	NC_010807.alt3	55.7692	52	24990	25041	34772	34854	29	23
NC_025457.ref	NC_010807.alt3	60.7843	51	20867	20917	5325	5407	31	20
NC_025457.ref	NC_010807.alt3	56	50	3860	3909	19371	19450	28	22
NC_025457.ref	NC_010807.alt3	66.6667	48	34483	34530	30030	30086	32	16
NC_025457.ref	NC_010807.alt3	67.3913	46	15618	15663	1426	1542	31	15
NC_025457.ref	NC_010807.alt3	63.0435	46	28508	28553	17652	17685	29	17
NC_025457.ref	NC_010807.alt3	6e+01	45	16009	16053	21303	21379	27	18
NC_025457.ref	NC_010807.alt3	55.5556	45	18382	18426	19287	19324	25	20
NC_025457.ref	NC_010807.alt3	66.6667	45	24668	24712	24567	24599	30	15
NC_025457.ref	NC_010807.alt3	76.7442	43	17812	17854	893	934	33	10
NC_025457.ref	NC_010807.alt3	58.5366	41	4838	4878	8232	8282	24	17
NC_025457.ref	NC_010807.alt3	65.8537	41	34717	34757	18429	18374	27	14
NC_025457.ref	NC_010807.alt3	7e+01	40	6856	6895	16540	16466	28	12
NC_025457.ref	NC_010807.alt3	6e+01	40	42486	42525	19271	19303	24	16
NC_025457.ref	NC_010807.alt3	57.8947	38	39008	39045	37485	37455	22	16
NC_025457.alt1	NC_010807.alt1	49.6241	133	27917	28049	19578	19816	66	67
NC_025457.alt1	NC_010807.alt1	44.4444	81	9580	9660	16906	17009	36	45
NC_025457.alt1	NC_010807.alt1	58.75	80	29152	29231	10804	10949	47	33
NC_025457.alt1	NC_010807.alt1	60.2941	68	30792	30859	7349	7437	41	27
NC_025457.alt1	NC_010807.alt1	54.5455	66	3893	3958	26271	26180	36	30
NC_025457.alt1	NC_010807.alt1	53.9683	63	40274	40336	3082	2997	34	29
NC_025457.alt1	NC_010807.alt1	55.7377	61	5921	5981	30751	30669	34	27
NC_025457.alt1	NC_010807.alt1	56.8966	58	4918	4975	27191	27111	33	25
NC_025457.alt1	NC_010807.alt1	34.4828	58	15346	15403	11307	11258	20	38
NC_025457.alt1	NC_010807.alt1	53.4483	58	38882	38939	25143	25233	31	27
NC_025457.alt1	NC_010807.alt1	53.5714	56	21531	21586	28279	28349	30	26
NC_025457.alt1	NC_010807.alt1	41.8182	55	31873	31927	16971	17016	23	32
NC_025457.alt1	NC_010807.alt1	62.9630	54	11255	11308	37482	37532	34	20
NC_025457.alt1	NC_010807.alt1	47.1698	53	28138	28190	19931	19889	25	28
NC_025457.alt1	NC_010807.alt1	48.0769	52	38006	38057	22718	22757	25	27
NC_025457.alt1	NC_010807.alt1	46	50	23677	23726	34289	34331	23	27
NC_025457.alt1	NC_010807.alt1	61.7021	47	31026	31072	19067	19136	29	18
NC_025457.alt1	NC_010807.alt1	63.0435	46	27464	27509	17099	17132	29	17
NC_025457.alt1	NC_010807.alt1	55.5556	45	17487	17531	18524	18561	25	20
NC_025457.alt1	NC_010807.alt1	76.7442	43	16917	16959	393	434	33	10
NC_025457.alt1	NC_010807.alt1	62.5	40	34705	34744	22616	22674	25	15
NC_025457.alt1	NC_010807.alt1	69.2308	39	6847	6885	13945	14018	27	12
NC_025457.alt1	NC_010807.alt1	69.4444	36	15086	15121	20982	21016	25	11
NC_025457.alt1	NC_010807.alt1	58.3333	36	22002	22037	1256	1293	21	15
NC_002486.ref	NC_025457.alt2	54.1667	96	7361	7456	44425	44347	52	44
NC_002486.ref	NC_025457.alt2	59.5238	84	40176	40259	2167	2074	50	34
NC_002486.ref	NC_025457.alt2	57.8125	64	1410	1473	4976	4925	37	27
NC_002486.ref	NC_025457.alt2	55.5556	63	26697	26759	39964	40075	35	28
NC_002486.ref	NC_025457.alt2	56.6667	60	10582	10641	23178	23228	34	26
NC_002486.ref	NC_025457.alt2	51.6667	60	43513	43572	30944	30985	31	29
NC_002486.ref	NC_025457.alt2	42.8571	56	7758	7813	27591	27633	24	32
NC_002486.ref	NC_025457.alt2	57.1429	56	15610	15665	28423	28504	32	24
NC_002486.ref	NC_025457.alt2	48.2143	56	32599	32654	57717	57673	27	29
NC_002486.ref	NC_025457.alt2	50.9434	53	17660	17712	71	33	27	26
NC_002486.ref	NC_025457.alt2	63.4615	52	24737	24788	906	980	33	19
NC_002486.ref	NC_025457.alt2	63.4615	52	36365	36416	2136	2068	33	19
NC_002486.ref	NC_025457.alt2	56.8627	51	6667	6717	60495	60549	29	22
NC_002486.ref	NC_025457.alt2	56.8627	51	29861	29911	58935	58975	29	22
NC_002486.ref	NC_025457.alt2	55.1020	49	36790	36838	9558	9623	27	22
NC_002486.ref	NC_025457.alt2	59.1837	49	39553	39601	2015	2072	29	20
NC_002486.ref	NC_025457.alt2	56.25	48	33767	33814	42630	42680	27	21
NC_002486.ref	NC_025457.alt2	70.2128	47	15704	15750	4436	4460	33	14
NC_002486.ref	NC_025457.alt2	63.0435	46	4325	4370	22180	22133	29	17
NC_002486.ref	NC_025457.alt2	63.0435	46	14319	14364	45055	45109	29	17
NC_002486.ref	NC_025457.alt2	6e+01	45	18417	18461	9312	9275	27	18
NC_002486.ref	NC_025457.alt2	61.3636	44	16350	16393	18452	18389	27	17
NC_002486.ref	NC_025457.alt2	65.9091	44	32553	32596	261	189	29	15
NC_002486.ref	NC_025457.alt2	69.7674	43	584	626	14822	14854	30	13
NC_002486.ref	NC_025457.alt2	76.7442	43	19068	19110	45198	45153	33	10
NC_002486.ref	NC_025457.alt2	59.5238	42	37442	37483	48919	48950	25	17
NC_002486.ref	NC_025457.alt2	65.8537	41	9978	10018	35475	35581	27	14
NC_002486.ref	NC_025457.alt2	56.0976	41	25543	25583	36764	36841	23	18
NC_002486.ref	NC_025457.alt2	55.2632	38	33164	33201	47194	47161	21	17
NC_002486.ref	NC_025457.alt2	78.3784	37	42426	42462	34361	34297	29	8
NC_002486.ref	NC_025457.alt2	77.7778	36	2318	2353	3650	3609	28	8
NC_002486.ref	NC_025457.alt2	66.6667	36	4194	4229	821	875	24	12
NC_002486.ref	NC_025457.alt2	69.4444	36	21166	21201	51189	51153	25	11
NC_002486.ref	NC_025457.alt2	65.7143	35	3237	3271	18222	18188	23	12
NC_002486.ref	NC_025457.alt2	71.4286	35	9430	9464	50309	50380	25	10
NC_002486.ref	NC_025457.alt2	74.2857	35	13776	13810	23229	23298	26	9
NC_002486.ref	NC_025457.alt2	68.5714	35	26006	26040	46987	47047	24	11
NC_002486.ref	NC_025457.alt2	71.4286	35	36602	36636	45738	45771	25	10
NC_002486.ref	NC_025457.alt2	68.5714	35	37650	37684	33849	33806	24	11
NC_002486.ref	NC_025457.alt2	62.8571	35	45177	45211	34315	34346	22	13
NC_010807.alt3	NC_002486.alt	46.0784	102	23922	24023	4471	4582	47	55
NC_010807.alt3	NC_002486.alt	41.1765	68	37456	37523	29989	30045	28	40
NC_010807.alt3	NC_002486.alt	54.8387	62	27377	27438	43842	43790	34	28
NC_010807.alt3	NC_002486.alt	44.8276	58	25123	25180	24927	24975	26	32
NC_010807.alt3	NC_002486.alt	56.8966	58	29617	29674	33801	33845	33	25
NC_010807.alt3	NC_002486.alt	56.8966	58	35535	35592	36838	36909	33	25
NC_010807.alt3	NC_002486.alt	50.8772	57	13847	13903	1059	1107	29	28
NC_010807.alt3	NC_002486.alt	66.0714	56	13173	13228	25560	25641	37	19
NC_010807.alt3	NC_002486.alt	48.0769	52	21000	21051	6147	6188	25	27
NC_010807.alt3	NC_002486.alt	5e+01	52	29173	29224	27186	27147	26	26
NC_010807.alt3	NC_002486.alt	54.9020	51	15899	15949	28769	28727	28	23
NC_010807.alt3	NC_002486.alt	40.8163	49	7545	7593	21638	21599	20	29
NC_010807.alt3	NC_002486.alt	62.5	48	13919	13966	43666	43749	30	18
NC_010807.alt3	NC_002486.alt	66.6667	48	16071	16118	3685	3649	32	16
NC_010807.alt3	NC_002486.alt	66.6667	48	18300	18347	18650	18538	32	16
NC_010807.alt3	NC_002486.alt	48.9362	47	29441	29487	12212	12175	23	24
NC_010807.alt3	NC_002486.alt	40.4255	47	33321	33367	2607	2646	19	28
NC_010807.alt3	NC_002486.alt	66.6667	45	18356	18400	8496	8417	30	15
NC_010807.alt3	NC_002486.alt	62.2222	45	18409	18453	33067	33006	28	17
NC_010807.alt3	NC_002486.alt	66.6667	45	21507	21551	23804	23727	30	15
NC_010807.alt3	NC_002486.alt	54.5455	44	3412	3455	25265	25185	24	20
NC_010807.alt3	NC_002486.alt	69.0476	42	3091	3132	2465	2519	29	13
NC_010807.alt3	NC_002486.alt	47.6190	42	9518	9559	38285	38318	20	22
NC_010807.alt3	NC_002486.alt	59.5238	42	33127	33168	12966	12921	25	17
NC_010807.alt2	NC_005091.alt1	51.7241	87	17566	17652	20995	21094	45	42
NC_010807.alt2	NC_005091.alt1	61.8421	76	29575	29650	17715	17812	47	29
NC_010807.alt2	NC_005091.alt1	57.5758	66	5260	5325	47072	46992	38	28
NC_010807.alt2	NC_005091.alt1	53.8462	65	30433	30497	44735	44659	35	30
NC_010807.alt2	NC_005091.alt1	58.0645	62	21899	21960	48646	48573	36	26
NC_010807.alt2	NC_005091.alt1	44.2623	61	29090	29150	30289	30333	27	34
NC_010807.alt2	NC_005091.alt1	55.7377	61	33851	33911	53682	53627	34	27
NC_010807.alt2	NC_005091.alt1	53.3333	60	3307	3366	55307	55399	32	28
NC_010807.alt2	NC_005091.alt1	5e+01	58	10654	10711	52150	52100	29	29
NC_010807.alt2	NC_005091.alt1	50.8772	57	31266	31322	33626	33585	29	28
NC_010807.alt2	NC_005091.alt1	53.5714	56	38410	38465	1442	1524	30	26
NC_010807.alt2	NC_005091.alt1	41.8182	55	20561	20615	42914	42871	23	32
NC_010807.alt2	NC_005091.alt1	46.2963	54	19210	19263	45995	45952	25	29
NC_010807.alt2	NC_005091.alt1	66.6667	54	31818	31871	38458	38518	36	18
NC_010807.alt2	NC_005091.alt1	47.1698	53	40059	40111	6608	6667	25	28
NC_010807.alt2	NC_005091.alt1	6e+01	50	16443	16492	43569	43492	30	20
NC_010807.alt2	NC_005091.alt1	63.2653	49	10724	10772	4343	4300	31	18
NC_010807.alt2	NC_005091.alt1	62.5	48	15392	15439	32778	32820	30	18
NC_010807.alt2	NC_005091.alt1	55.3191	47	18054	18100	37027	36993	26	21
NC_010807.alt2	NC_005091.alt1	46.6667	45	4745	4789	35131	35058	21	24
NC_010807.alt2	NC_005091.alt1	61.3636	44	26994	27037	33847	33883	27	17
NC_010807.alt2	NC_005091.alt1	65.9091	44	29699	29742	47882	47963	29	15
NC_010807.alt2	NC_005091.alt1	68.1818	44	32462	32505	55654	55704	30	14
NC_010807.alt2	NC_005091.alt1	66.6667	42	12899	12940	36783	36821	28	14
NC_010807.alt2	NC_005091.alt1	73.8095	42	14489	14530	27186	27124	31	11
NC_010807.alt2	NC_005091.alt1	71.4286	42	26013	26054	54619	54694	30	12
NC_010807.alt2	NC_005091.alt1	54.7619	42	28361	28402	10549	10614	23	19
NC_010807.alt2	NC_005091.alt1	7e+01	40	15262	15301	8084	8159	28	12
NC_010807.alt2	NC_005091.alt1	72.5	40	20927	20966	42441	42385	29	11
NC_010807.alt2	NC_005091.alt1	51.2821	39	16917	16955	44198	44169	20	19
NC_010807.alt2	NC_005091.alt1	69.2308	39	22076	22114	35656	35612	27	12
NC_010807.alt2	NC_005091.alt1	63.1579	38	22524	22561	29700	29667	24	14
NC_010807.alt2	NC_005091.alt1	64.8649	37	11410	11446	17216	17181	24	13
NC_010807.alt2	NC_005091.alt1	67.5676	37	29405	29441	32159	32123	25	12
NC_010807.alt2	NC_005091.alt1	63.8889	36	7711	7746	17975	17919	23	13
NC_010807.alt2	NC_005091.alt1	75	36	11922	11957	35111	35064	27	9
NC_010807.alt2	NC_005091.alt1	66.6667	36	20368	20403	50573	50546	24	12
NC_010807.alt2	NC_005091.alt1	62.8571	35	19003	19037	54412	54378	22	13
NC_010807.alt2	NC_005091.alt1	71.4286	35	25123	25157	26823	26863	25	10
NC_010807.alt3	NC_002486.ref	46.0784	102	23922	24023	34895	35006	47	55
NC_010807.alt3	NC_002486.ref	41.1765	68	37456	37523	15648	15592	28	40
NC_010807.alt3	NC_002486.ref	54.8387	62	27377	27438	13418	13366	34	28
NC_010807.alt3	NC_002486.ref	56.8966	58	29617	29674	3377	3421	33	25
NC_010807.alt3	NC_002486.ref	56.8966	58	35535	35592	6414	6485	33	25
NC_010807.alt3	NC_002486.ref	50.8772	57	13847	13903	31483	31531	29	28
NC_010807.alt3	NC_002486.ref	66.0714	56	13173	13228	20077	19996	37	19
NC_010807.alt3	NC_002486.ref	48.0769	52	21000	21051	36571	36612	25	27
NC_010807.alt3	NC_002486.ref	5e+01	52	29173	29224	18451	18490	26	26
NC_010807.alt3	NC_002486.ref	54.9020	51	15899	15949	16868	16910	28	23
NC_010807.alt3	NC_002486.ref	40.8163	49	7545	7593	23999	24038	20	29
NC_010807.alt3	NC_002486.ref	62.5	48	13919	13966	13242	13325	30	18
NC_010807.alt3	NC_002486.ref	66.6667	48	16071	16118	34109	34073	32	16
NC_010807.alt3	NC_002486.ref	66.6667	48	18300	18347	26987	27099	32	16
NC_010807.alt3	NC_002486.ref	48.9362	47	29441	29487	42636	42599	23	24
NC_010807.alt3	NC_002486.ref	40.4255	47	33321	33367	33031	33070	19	28
NC_010807.alt3	NC_002486.ref	66.6667	45	18356	18400	38920	38841	30	15
NC_010807.alt3	NC_002486.ref	62.2222	45	18409	18453	2643	2582	28	17
NC_010807.alt3	NC_002486.ref	66.6667	45	21507	21551	21833	21910	30	15
NC_010807.alt3	NC_002486.ref	54.5455	44	3412	3455	20372	20452	24	20
NC_010807.alt3	NC_002486.ref	69.0476	42	3091	3132	32889	32943	29	13
NC_010807.alt3	NC_002486.ref	47.6190	42	9518	9559	7861	7894	20	22
NC_010807.alt3	NC_002486.ref	59.5238	42	33127	33168	43390	43345	25	17
NC_010807.alt2	NC_010807.alt1	98.5667	4186	25916	30101	24883	29068	4126	60
NC_010807.alt2	NC_010807.alt1	98.7294	3935	20285	24219	19341	23275	3885	50
NC_010807.alt2	NC_010807.alt1	98.9278	3451	34551	38001	32984	36434	3414	37
NC_010807.alt2	NC_010807.alt1	98.3515	3033	8520	11552	7198	10230	2983	50
NC_010807.alt2	NC_010807.alt1	98.4065	2573	3533	6105	2629	5201	2532	41
NC_010807.alt2	NC_010807.alt1	99.2172	2555	31133	33687	29822	32376	2535	20
NC_010807.alt2	NC_010807.alt1	98.8645	2554	38002	40555	36262	38815	2525	29
NC_010807.alt2	NC_010807.alt1	98.8465	2254	12809	15062	11551	13804	2228	26
NC_010807.alt2	NC_010807.alt1	98.5769	1827	1132	2958	577	2403	1801	26
NC_010807.alt2	NC_010807.alt1	98.6194	1666	17169	18834	16109	17774	1643	23
NC_010807.alt2	NC_010807.alt1	98.6700	1579	24220	25798	23187	24765	1558	21
NC_010807.alt2	NC_010807.alt1	98.3716	1351	18934	20284	17874	19224	1329	22
NC_010807.alt2	NC_010807.alt1	98.6888	1144	11665	12808	10227	11370	1129	15
NC_010807.alt2	NC_010807.alt1	98.7907	1075	6930	8004	5718	6792	1062	13
NC_010807.alt2	NC_010807.alt1	98.9331	1031	30102	31132	28977	30007	1020	11
NC_010807.alt2	NC_010807.alt1	99.3534	928	15655	16582	14588	15515	922	6
NC_010807.alt2	NC_010807.alt1	98.8176	592	15063	15654	13712	14303	585	7
NC_010807.alt2	NC_010807.alt1	99.1468	586	16583	17168	15678	16263	581	5
NC_010807.alt2	NC_010807.alt1	99.4475	543	6387	6929	5323	5865	540	3
NC_010807.alt2	NC_010807.alt1	99.1614	477	34074	34550	32621	33097	473	4
NC_010807.alt2	NC_010807.alt1	99.1453	468	502	969	109	576	464	4
NC_010807.alt2	NC_010807.alt1	99.2736	413	8107	8519	6895	7307	410	3
NC_010807.alt2	NC_010807.alt1	99.4924	394	2959	3352	2235	2628	392	2
NC_010807.alt2	NC_010807.alt1	98.2517	286	33788	34073	32477	32762	281	5
NC_010807.alt2	NC_010807.alt1	1e+02	183	1	183	38586	38768	183	0
NC_010807.alt2	NC_010807.alt1	98.3333	180	3353	3532	11371	11550	177	3
NC_010807.alt2	NC_010807.alt1	99.3827	162	340	501	14465	14304	161	1
NC_010807.alt2	NC_010807.alt1	1e+02	162	970	1131	15516	15677	162	0
NC_010807.alt2	NC_010807.alt1	99.3590	156	184	339	38660	38815	155	1
NC_010807.alt2	NC_010807.alt1	1e+02	156	6110	6265	5046	5201	156	0
NC_010807.alt2	NC_010807.alt1	98.3471	121	6266	6386	5322	5202	119	2
NC_010807.alt2	NC_010807.alt1	96.5812	117	25799	25915	24873	24757	113	4
NC_010807.alt2	NC_010807.alt1	96.4286	112	11553	11664	19335	19224	108	4
NC_010807.alt2	NC_010807.alt1	99.0196	102	8005	8106	6894	6793	101	1
NC_010807.alt2	NC_010807.alt1	96	100	33688	33787	32475	32376	96	4
NC_010807.alt2	NC_010807.alt1	97.9798	99	18835	18933	17872	17774	97	2
NC_010807.alt3	NC_025457.ref	61.7647	102	5381	5482	20785	20924	63	39
NC_010807.alt3	NC_025457.ref	54.7619	84	24270	24353	29055	29154	46	38
NC_010807.alt3	NC_025457.ref	55.5556	72	33458	33529	37093	37011	40	32
NC_010807.alt3	NC_025457.ref	55.5556	63	17093	17155	37857	37953	35	28
NC_010807.alt3	NC_025457.ref	5e+01	60	22555	22614	28085	28165	30	30
NC_010807.alt3	NC_025457.ref	60.3448	58	8973	9030	18932	19020	35	23
NC_010807.alt3	NC_025457.ref	67.2414	58	11292	11349	17573	17683	39	19
NC_010807.alt3	NC_025457.ref	56.8966	58	13408	13465	26948	27023	33	25
NC_010807.alt3	NC_025457.ref	42.1053	57	11931	11987	21990	21941	24	33
NC_010807.alt3	NC_025457.ref	57.8947	57	30030	30086	34483	34530	33	24
NC_010807.alt3	NC_025457.ref	49.0909	55	16197	16251	27247	27288	27	28
NC_010807.alt3	NC_025457.ref	55.7692	52	9954	10005	4950	4883	29	23
NC_010807.alt3	NC_025457.ref	48.0769	52	11659	11710	3593	3635	25	27
NC_010807.alt3	NC_025457.ref	65.3846	52	18381	18432	40994	41094	34	18
NC_010807.alt3	NC_025457.ref	56.8627	51	8232	8282	4838	4879	29	22
NC_010807.alt3	NC_025457.ref	52.9412	51	31739	31789	25802	25855	27	24
NC_010807.alt3	NC_025457.ref	58.8235	51	38558	38608	11884	11937	30	21
NC_010807.alt3	NC_025457.ref	72.9167	48	20896	20943	12743	12798	35	13
NC_010807.alt3	NC_025457.ref	56.25	48	25283	25330	35479	35441	27	21
NC_010807.alt3	NC_025457.ref	60.4167	48	28166	28213	4066	4010	29	19
NC_010807.alt3	NC_025457.ref	63.0435	46	28297	28342	23967	24030	29	17
NC_010807.alt3	NC_025457.ref	55.5556	45	5055	5099	33858	33894	25	20
NC_010807.alt3	NC_025457.ref	53.3333	45	6322	6366	25297	25331	24	21
NC_010807.alt3	NC_025457.ref	66.6667	45	10024	10068	6710	6788	30	15
NC_010807.alt3	NC_025457.ref	55.5556	45	10215	10259	35806	35843	25	20
NC_010807.alt3	NC_025457.ref	68.8889	45	20186	20230	24112	24148	31	14
NC_010807.alt3	NC_025457.ref	64.4444	45	26354	26398	30934	30893	29	16
NC_010807.alt3	NC_025457.ref	60.4651	43	1271	1313	4943	4996	26	17
NC_010807.alt3	NC_025457.ref	67.5	40	5970	6009	10479	10529	27	13
NC_010807.alt3	NC_025457.ref	64.1026	39	19628	19666	34344	34406	25	14
NC_010807.alt3	NC_025457.ref	55.2632	38	2120	2157	23227	23262	21	17
NC_010807.alt3	NC_025457.ref	73.6842	38	38226	38263	24445	24518	28	10
NC_010807.alt3	NC_025457.ref	69.4444	36	9686	9721	23927	23956	25	11
NC_010807.alt3	NC_025457.ref	61.1111	36	37135	37170	19881	19853	22	14
NC_010807.alt3	NC_025457.ref	71.4286	35	19489	19523	12874	12918	25	10
NC_010807.alt3	NC_025457.ref	6e+01	35	25054	25088	32499	32533	21	14
NC_010807.alt2	NC_005091.alt2	47.5728	103	35734	35836	28996	28872	49	54
NC_010807.alt2	NC_005091.alt2	51.6484	91	19401	19491	21819	21884	47	44
NC_010807.alt2	NC_005091.alt2	43.9394	66	23939	24004	23328	23404	29	37
NC_010807.alt2	NC_005091.alt2	39.0625	64	25380	25443	54994	54939	25	39
NC_010807.alt2	NC_005091.alt2	56.25	64	36102	36165	61883	61811	36	28
NC_010807.alt2	NC_005091.alt2	53.3333	60	3307	3366	61410	61502	32	28
NC_010807.alt2	NC_005091.alt2	61.6667	60	16047	16106	18224	18173	37	23
NC_010807.alt2	NC_005091.alt2	43.1034	58	9142	9199	51609	51655	25	33
NC_010807.alt2	NC_005091.alt2	51.7241	58	10654	10711	57112	57062	30	28
NC_010807.alt2	NC_005091.alt2	43.1034	58	20557	20614	46652	46605	25	33
NC_010807.alt2	NC_005091.alt2	53.4483	58	37708	37765	48234	48187	31	27
NC_010807.alt2	NC_005091.alt2	53.4483	58	39409	39466	34100	34036	31	27
NC_010807.alt2	NC_005091.alt2	63.1579	57	16196	16252	23007	23079	36	21
NC_010807.alt2	NC_005091.alt2	50.8772	57	31266	31322	36884	36844	29	28
NC_010807.alt2	NC_005091.alt2	52.6316	57	36621	36677	18544	18611	30	27
NC_010807.alt2	NC_005091.alt2	55.5556	54	28784	28837	29212	29168	30	24
NC_010807.alt2	NC_005091.alt2	66.6667	54	31818	31871	3124	3184	36	18
NC_010807.alt2	NC_005091.alt2	61.1111	54	35044	35097	41164	41099	33	21
NC_010807.alt2	NC_005091.alt2	52.8302	53	11180	11232	14575	14506	28	25
NC_010807.alt2	NC_005091.alt2	54.9020	51	39477	39527	17062	17098	28	23
NC_010807.alt2	NC_005091.alt2	5e+01	50	13665	13714	56921	56880	25	25
NC_010807.alt2	NC_005091.alt2	64	50	17718	17767	55482	55402	32	18
NC_010807.alt2	NC_005091.alt2	43.75	48	14914	14961	33121	33083	21	27
NC_010807.alt2	NC_005091.alt2	61.7021	47	1236	1282	13198	13280	29	18
NC_010807.alt2	NC_005091.alt2	59.5745	47	4438	4484	19639	19584	28	19
NC_010807.alt2	NC_005091.alt2	57.4468	47	30554	30600	18743	18827	27	20
NC_010807.alt2	NC_005091.alt2	46.6667	45	4745	4789	39049	38976	21	24
NC_010807.alt2	NC_005091.alt2	59.0909	44	17566	17609	23470	23532	26	18
NC_010807.alt2	NC_005091.alt2	68.1818	44	32462	32505	61757	61807	30	14
NC_010807.alt2	NC_005091.alt2	53.4884	43	1517	1559	23421	23375	23	20
NC_010807.alt2	NC_005091.alt2	74.4186	43	26012	26054	60721	60797	32	11
NC_010807.alt2	NC_005091.alt2	69.0476	42	4036	4077	43199	43145	29	13
NC_010807.alt2	NC_005091.alt2	61.9048	42	6271	6312	23565	23640	26	16
NC_010807.alt2	NC_005091.alt2	73.8095	42	14489	14530	29991	29929	31	11
NC_010807.alt2	NC_005091.alt2	63.4146	41	20056	20096	40174	40113	26	15
NC_010807.alt2	NC_005091.alt2	6e+01	40	1649	1688	7283	7239	24	16
NC_010807.alt2	NC_005091.alt2	57.5	40	17774	17813	60688	60719	23	17
NC_010807.alt2	NC_005091.alt2	62.5	40	30249	30288	17715	17785	25	15
NC_010807.alt2	NC_005091.alt2	74.3590	39	4594	4632	16130	16190	29	10
NC_010807.alt2	NC_005091.alt2	58.9744	39	23008	23046	8070	8029	23	16
NC_010807.alt2	NC_005091.alt2	66.6667	39	28945	28983	45313	45266	26	13
NC_010807.alt2	NC_005091.alt2	68.4211	38	28233	28270	37131	37090	26	12
NC_010807.alt2	NC_005091.alt2	76.3158	38	39993	40030	36844	36913	29	9
NC_010807.alt2	NC_005091.alt2	64.8649	37	11410	11446	18573	18538	24	13
NC_010807.alt2	NC_005091.alt2	75.6757	37	21964	22000	36212	36143	28	9
NC_010807.alt2	NC_005091.alt2	67.5676	37	29405	29441	35666	35630	25	12
NC_010807.alt2	NC_005091.alt2	69.4444	36	2007	2042	33060	33089	25	11
NC_025457.alt1	NC_010807.alt2	59	100	40858	40957	4782	4935	59	41
NC_025457.alt1	NC_010807.alt2	6e+01	80	29152	29231	12242	12387	48	32
NC_025457.alt1	NC_010807.alt2	54.5455	66	3893	3958	27304	27213	36	30
NC_025457.alt1	NC_010807.alt2	57.8125	64	21531	21594	29312	29405	37	27
NC_025457.alt1	NC_010807.alt2	52.3810	63	40274	40336	3986	3901	33	30
NC_025457.alt1	NC_010807.alt2	55.7377	61	5921	5981	32062	31980	34	27
NC_025457.alt1	NC_010807.alt2	34.4828	58	15346	15403	12745	12696	20	38
NC_025457.alt1	NC_010807.alt2	55.1724	58	38882	38939	26176	26266	32	26
NC_025457.alt1	NC_010807.alt2	56.1404	57	24721	24777	35529	35624	32	25
NC_025457.alt1	NC_010807.alt2	60.7143	56	39904	39959	21510	21444	34	22
NC_025457.alt1	NC_010807.alt2	41.8182	55	31873	31927	18031	18076	23	32
NC_025457.alt1	NC_010807.alt2	62.9630	54	11255	11308	39222	39272	34	20
NC_025457.alt1	NC_010807.alt2	46	50	23677	23726	35856	35898	23	27
NC_025457.alt1	NC_010807.alt2	66	50	38020	38069	24968	25049	33	17
NC_025457.alt1	NC_010807.alt2	51.0638	47	13234	13280	1125	1160	24	23
NC_025457.alt1	NC_010807.alt2	63.0435	46	27464	27509	18159	18192	29	17
NC_025457.alt1	NC_010807.alt2	55.5556	45	17487	17531	19584	19621	25	20
NC_025457.alt1	NC_010807.alt2	74.4186	43	16917	16959	786	827	32	11
NC_025457.alt1	NC_010807.alt2	68.2927	41	33058	33098	18936	18881	28	13
NC_025457.alt1	NC_010807.alt2	65	40	30792	30831	8671	8705	26	14
NC_025457.alt1	NC_010807.alt2	69.2308	39	6847	6885	15296	15369	27	12
NC_025457.alt1	NC_010807.alt2	61.5385	39	9580	9618	17966	18039	24	15
NC_025457.alt1	NC_010807.alt2	69.4444	36	15086	15121	21926	21960	25	11
NC_025457.alt1	NC_010807.alt2	58.3333	36	22002	22037	1811	1848	21	15
NC_010807.alt3	NC_010807.alt1	99.5918	2695	29934	32628	29682	32376	2684	11
NC_010807.alt3	NC_010807.alt1	99.0596	2233	8840	11072	7998	10230	2212	21
NC_010807.alt3	NC_010807.alt1	99.6077	2039	20094	22132	19773	21811	2031	8
NC_010807.alt3	NC_010807.alt1	99.6228	1856	26510	28365	26371	28226	1849	7
NC_010807.alt3	NC_010807.alt1	99.3899	1639	33173	34811	32690	34328	1629	10
NC_010807.alt3	NC_010807.alt1	99.4386	1603	22250	23852	21820	23422	1594	9
NC_010807.alt3	NC_010807.alt1	99.5572	1581	38311	39891	37235	38815	1574	7
NC_010807.alt3	NC_010807.alt1	99.4888	1565	1441	3005	577	2141	1557	8
NC_010807.alt3	NC_010807.alt1	99.5356	1292	28366	29657	28389	29680	1286	6
NC_010807.alt3	NC_010807.alt1	99.5734	1172	24217	25388	23594	24765	1167	5
NC_010807.alt3	NC_010807.alt1	99.5629	1144	11185	12328	10227	11370	1139	5
NC_010807.alt3	NC_010807.alt1	99.5614	1140	4985	6124	3922	5061	1135	5
NC_010807.alt3	NC_010807.alt1	99.4704	1133	16047	17179	15678	16810	1127	6
NC_010807.alt3	NC_010807.alt1	99.6307	1083	3902	4984	2629	3711	1079	4
NC_010807.alt3	NC_010807.alt1	98.8701	1062	13857	14918	13242	14303	1050	12
NC_010807.alt3	NC_010807.alt1	99.5243	1051	7651	8701	6947	7997	1046	5
NC_010807.alt3	NC_010807.alt1	99.4100	1017	12338	13354	11655	12671	1011	6
NC_010807.alt3	NC_010807.alt1	99.5859	966	17362	18327	16809	17774	962	4
NC_010807.alt3	NC_010807.alt1	99.1160	905	19025	19929	18262	19166	897	8
NC_010807.alt3	NC_010807.alt1	99.2898	704	36380	37083	35582	36285	699	5
NC_010807.alt3	NC_010807.alt1	99.7010	669	15378	16046	14847	15515	667	2
NC_010807.alt3	NC_010807.alt1	98.9865	592	7059	7650	6143	6734	586	6
NC_010807.alt3	NC_010807.alt1	99.2806	556	25459	26014	25113	25668	552	4
NC_010807.alt3	NC_010807.alt1	1e+02	520	35648	36167	35062	35581	520	0
NC_010807.alt3	NC_010807.alt1	99.7980	495	26015	26509	25778	26272	494	1
NC_010807.alt3	NC_010807.alt1	99.5781	474	13355	13828	12783	13256	472	2
NC_010807.alt3	NC_010807.alt1	1e+02	468	609	1076	109	576	468	0
NC_010807.alt3	NC_010807.alt1	98.8987	454	34910	35363	34329	34782	449	5
NC_010807.alt3	NC_010807.alt1	99.75	400	6553	6952	5743	6142	399	1
NC_010807.alt3	NC_010807.alt1	99.4845	388	18427	18814	17874	18261	386	2
NC_010807.alt3	NC_010807.alt1	99.1870	369	37757	38125	36521	36889	366	3
NC_010807.alt3	NC_010807.alt1	1e+02	282	6271	6552	5323	5604	282	0
NC_010807.alt3	NC_010807.alt1	1e+02	276	29658	29933	37234	36959	276	0
NC_010807.alt3	NC_010807.alt1	99.6169	261	14919	15179	14588	14848	260	1
NC_010807.alt3	NC_010807.alt1	1e+02	237	3342	3578	25110	24874	237	0
NC_010807.alt3	NC_010807.alt1	1e+02	236	37293	37528	36285	36520	236	0
NC_010807.alt3	NC_010807.alt1	96.2963	216	1	216	38586	38801	208	8
NC_010807.alt3	NC_010807.alt1	99.0610	213	32729	32941	32477	32689	211	2
NC_010807.alt3	NC_010807.alt1	99.5215	209	37084	37292	3915	3707	208	1
NC_010807.alt3	NC_010807.alt1	1e+02	192	18833	19024	2628	2437	192	0
NC_010807.alt3	NC_010807.alt1	98.9247	186	423	608	14489	14304	184	2
NC_010807.alt3	NC_010807.alt1	1e+02	175	3167	3341	2141	2315	175	0
NC_010807.alt3	NC_010807.alt1	1e+02	164	19930	20093	19511	19674	164	0
NC_010807.alt3	NC_010807.alt1	1e+02	163	23948	24110	23423	23585	163	0
NC_010807.alt3	NC_010807.alt1	1e+02	162	37595	37756	19341	19502	162	0
NC_010807.alt3	NC_010807.alt1	99.3789	161	3006	3166	28228	28388	160	1
NC_010807.alt3	NC_010807.alt1	99.3789	161	35487	35647	34795	34955	160	1
NC_010807.alt3	NC_010807.alt1	1e+02	152	3750	3901	11399	11550	152	0
NC_010807.alt3	NC_010807.alt1	1e+02	138	8702	8839	5742	5605	138	0
NC_010807.alt3	NC_010807.alt1	96.8254	126	3624	3749	2321	2446	122	4
NC_010807.alt3	NC_010807.alt1	94.3089	123	35364	35486	12673	12795	116	7
NC_010807.alt3	NC_010807.alt1	96.7213	122	1077	1198	15516	15637	118	4
NC_010807.alt3	NC_010807.alt1	1e+02	121	6150	6270	5322	5202	121	0
NC_010807.alt3	NC_010807.alt1	98.2906	117	22133	22249	25777	25661	115	2
NC_010807.alt3	NC_010807.alt1	1e+02	115	38126	38240	5175	5061	115	0
NC_010807.alt3	NC_010807.alt1	1e+02	112	11073	11184	19335	19224	112	0
NC_010807.alt3	NC_010807.alt1	1e+02	106	6953	7058	34956	35061	106	0
NC_010807.alt3	NC_010807.alt1	94.3396	106	24111	24216	19675	19780	100	6
NC_010807.alt3	NC_010807.alt1	1e+02	102	36220	36321	6793	6894	102	0
NC_010807.alt3	NC_010807.alt1	1e+02	100	32629	32728	32475	32376	100	0
NC_010807.alt3	NC_010807.alt1	1e+02	99	18328	18426	17872	17774	99	0
NC_010807.alt3	NC_010807.alt1	1e+02	98	34812	34909	26273	26370	98	0
NC_010807.alt3	NC_010807.alt1	1e+02	95	23853	23947	11564	11658	95	0
NC_010807.alt3	NC_010807.alt1	1e+02	70	25389	25458	24873	24804	70	0
NC_010807.alt3	NC_010807.alt1	1e+02	70	38241	38310	36890	36959	70	0
NC_010807.alt3	NC_010807.alt1	96.9697	66	37529	37594	19159	19224	64	2
NC_010807.alt3	NC_010807.alt1	98.2759	58	36322	36379	6792	6735	57	1
NC_010807.alt3	NC_010807.alt1	1e+02	52	36168	36219	6946	6895	52	0
NC_010807.alt3	NC_010807.alt1	1e+02	45	1394	1438	15631	15675	45	0
NC_010807.alt3	NC_010807.alt1	97.7778	45	3579	3623	24766	24810	44	1
NC_025457.ref	NC_025457.alt2	91.1632	1109	7455	8563	10905	12040	1011	98
NC_025457.ref	NC_025457.alt2	91.2631	1053	41329	42381	62572	63630	961	92
NC_025457.ref	NC_025457.alt2	90.6977	817	2204	3020	3375	4198	741	76
NC_025457.ref	NC_025457.alt2	91.0467	793	27683	28475	41700	42492	722	71
NC_025457.ref	NC_025457.alt2	91.8231	746	19850	20595	30361	31120	685	61
NC_025457.ref	NC_025457.alt2	88.8889	720	24969	25688	38039	38783	640	80
NC_025457.ref	NC_025457.alt2	89.7810	685	5094	5778	7286	7970	615	70
NC_025457.ref	NC_025457.alt2	88.5981	535	14211	14745	22123	22668	474	61
NC_025457.ref	NC_025457.alt2	88.1323	514	19073	19586	29630	30157	453	61
NC_025457.ref	NC_025457.alt2	88.0240	501	11549	12049	18330	18830	441	60
NC_025457.ref	NC_025457.alt2	92	500	36341	36840	54198	54697	460	40
NC_025457.ref	NC_025457.alt2	89.3788	499	22197	22695	34026	34524	446	53
NC_025457.ref	NC_025457.alt2	93.1034	464	18065	18528	27979	28442	432	32
NC_025457.ref	NC_025457.alt2	91.5033	459	40677	41135	61259	61750	420	39
NC_025457.ref	NC_025457.alt2	95.3846	455	27228	27682	41145	41599	434	21
NC_025457.ref	NC_025457.alt2	90.8884	439	8564	9002	12287	12725	399	40
NC_025457.ref	NC_025457.alt2	89.6552	435	6029	6463	8882	9316	390	45
NC_025457.ref	NC_025457.alt2	88.0562	427	3980	4406	5318	5744	376	51
NC_025457.ref	NC_025457.alt2	88.9930	427	32454	32880	49023	49449	380	47
NC_025457.ref	NC_025457.alt2	87.7934	426	17052	17477	26352	26777	374	52
NC_025457.ref	NC_025457.alt2	88.6525	423	35517	35939	53043	53465	375	48
NC_025457.ref	NC_025457.alt2	90.2844	422	389	810	581	1002	381	41
NC_025457.ref	NC_025457.alt2	91.1905	420	26183	26602	39523	39981	383	37
NC_025457.ref	NC_025457.alt2	96.3855	415	14749	15163	22703	23117	400	15
NC_025457.ref	NC_025457.alt2	95.1691	414	16539	16952	25554	25967	394	20
NC_025457.ref	NC_025457.alt2	88.7255	408	20596	21003	31279	31695	362	46
NC_025457.ref	NC_025457.alt2	91.0224	401	35940	36340	53701	54103	365	36
NC_025457.ref	NC_025457.alt2	91.3706	394	35123	35516	52550	52947	360	34
NC_025457.ref	NC_025457.alt2	88.1137	387	9731	10117	14644	15030	341	46
NC_025457.ref	NC_025457.alt2	88.8298	376	22821	23196	34823	35198	334	42
NC_025457.ref	NC_025457.alt2	90.2174	368	23900	24267	36303	36670	332	36
NC_025457.ref	NC_025457.alt2	93.4605	367	6723	7089	9782	10148	343	24
NC_025457.ref	NC_025457.alt2	89.4150	359	24355	24713	36758	37116	321	38
NC_025457.ref	NC_025457.alt2	95.6647	346	40301	40646	60312	60657	331	15
NC_025457.ref	NC_025457.alt2	90.2367	338	7090	7427	10324	10661	305	33
NC_025457.ref	NC_025457.alt2	89.9110	337	39962	40298	59904	60240	303	34
NC_025457.ref	NC_025457.alt2	95.1952	333	30282	30614	45761	46093	317	16
NC_025457.ref	NC_025457.alt2	87.8049	328	29717	30044	44805	45132	288	40
NC_025457.ref	NC_025457.alt2	87.7676	327	39635	39961	59494	59858	287	40
NC_025457.ref	NC_025457.alt2	91.2773	321	21004	21324	31904	32224	293	28
NC_025457.ref	NC_025457.alt2	90.9091	308	30615	30922	46343	46650	280	28
NC_025457.ref	NC_025457.alt2	85.5263	304	15890	16193	24452	24755	260	44
NC_025457.ref	NC_025457.alt2	89.4389	303	12385	12687	19063	19371	271	32
NC_025457.ref	NC_025457.alt2	89.6667	300	13578	13877	21053	21372	269	31
NC_025457.ref	NC_025457.alt2	90.8784	296	26932	27227	40768	41063	269	27
NC_025457.ref	NC_025457.alt2	94.8980	294	39205	39498	58795	59088	279	15
NC_025457.ref	NC_025457.alt2	95.5172	290	3687	3976	4801	5090	277	13
NC_025457.ref	NC_025457.alt2	88.9273	289	947	1235	1431	1719	257	32
NC_025457.ref	NC_025457.alt2	97.2318	289	12696	12984	19612	19900	281	8
NC_025457.ref	NC_025457.alt2	88.5417	288	33676	33963	50239	50526	255	33
NC_025457.ref	NC_025457.alt2	97.2125	287	13012	13298	20209	20495	279	8
NC_025457.ref	NC_025457.alt2	96.1131	283	4647	4929	6282	6564	272	11
NC_025457.ref	NC_025457.alt2	93.9716	282	23347	23628	35333	35614	265	17
NC_025457.ref	NC_025457.alt2	94.6809	282	37207	37488	55453	55734	267	15
NC_025457.ref	NC_025457.alt2	87.0036	277	21495	21771	32824	33100	241	36
NC_025457.ref	NC_025457.alt2	90.9420	276	13935	14210	21656	21931	251	25
NC_025457.ref	NC_025457.alt2	1e+02	275	38722	38996	47615	47889	275	0
NC_025457.ref	NC_025457.alt2	89.2193	269	10336	10604	15633	15901	240	29
NC_025457.ref	NC_025457.alt2	91.3208	265	1390	1654	2180	2471	242	23
NC_025457.ref	NC_025457.alt2	1e+02	262	12123	12384	45487	45748	262	0
NC_025457.ref	NC_025457.alt2	93.8697	261	17798	18058	27575	27835	245	16
NC_025457.ref	NC_025457.alt2	95.3488	258	17540	17797	27168	27425	246	12
NC_025457.ref	NC_025457.alt2	90.8	250	37850	38099	56800	57049	227	23
NC_025457.ref	NC_025457.alt2	90.3226	248	141	388	291	538	224	24
NC_025457.ref	NC_025457.alt2	91.9355	248	6475	6722	9417	9664	228	20
NC_025457.ref	NC_025457.alt2	1e+02	247	32881	33127	12284	12038	247	0
NC_025457.ref	NC_025457.alt2	91.3934	244	11055	11298	17300	17543	223	21
NC_025457.ref	NC_025457.alt2	93.0328	244	31645	31888	48014	48257	227	17
NC_025457.ref	NC_025457.alt2	91.7355	242	28785	29026	43294	43535	222	20
NC_025457.ref	NC_025457.alt2	88.7967	241	33964	34204	50714	50964	214	27
NC_025457.ref	NC_025457.alt2	90.8333	240	34881	35120	52203	52442	218	22
NC_025457.ref	NC_025457.alt2	97.4684	237	4407	4643	5878	6114	231	6
NC_025457.ref	NC_025457.alt2	88.5106	235	30045	30279	45262	45496	208	27
NC_025457.ref	NC_025457.alt2	92.2078	231	31894	32124	48392	48622	213	18
NC_025457.ref	NC_025457.alt2	89.1304	230	24719	24948	37452	37681	205	25
NC_025457.ref	NC_025457.alt2	89.0830	229	42382	42610	63785	64013	204	25
NC_025457.ref	NC_025457.alt2	86.2832	226	3247	3472	4574	4813	195	31
NC_025457.ref	NC_025457.alt2	89.7321	224	25697	25920	38849	39072	201	23
NC_025457.ref	NC_025457.alt2	96.3636	220	28478	28697	42623	42842	212	8
NC_025457.ref	NC_025457.alt2	91.5493	213	16197	16409	24851	25063	195	18
NC_025457.ref	NC_025457.alt2	87.7934	213	23629	23841	35814	36026	187	26
NC_025457.ref	NC_025457.alt2	89.5735	211	34205	34415	51178	51391	189	22
NC_025457.ref	NC_025457.alt2	92.3445	209	26605	26813	40199	40407	193	16
NC_025457.ref	NC_025457.alt2	87.9808	208	1996	2203	3137	3344	183	25
NC_025457.ref	NC_025457.alt2	89.3720	207	32244	32450	48622	48882	185	22
NC_025457.ref	NC_025457.alt2	91.4573	199	1797	1995	2796	2994	182	17
NC_025457.ref	NC_025457.alt2	96.9388	196	15164	15359	14238	14043	190	6
NC_025457.ref	NC_025457.alt2	94.3590	195	37012	37206	55168	55362	184	11
NC_025457.ref	NC_025457.alt2	91.7098	193	29269	29461	44112	44338	177	16
NC_025457.ref	NC_025457.alt2	1e+02	188	30923	31110	8312	8499	188	0
NC_025457.ref	NC_025457.alt2	95.7219	187	34556	34742	51768	51954	179	8
NC_025457.ref	NC_025457.alt2	92.8962	183	9006	9188	12750	12932	170	13
NC_025457.ref	NC_025457.alt2	1e+02	183	38100	38282	57164	57346	183	0
NC_025457.ref	NC_025457.alt2	90.1099	182	37668	37849	56513	56694	164	18
NC_025457.ref	NC_025457.alt2	91.6667	180	31326	31505	47261	47478	165	15
NC_025457.ref	NC_025457.alt2	85.9551	178	10874	11051	16845	17022	153	25
NC_025457.ref	NC_025457.alt2	97.7143	175	21861	22035	33405	33579	171	4
NC_025457.ref	NC_025457.alt2	88.5057	174	10700	10873	16550	16723	154	20
NC_025457.ref	NC_025457.alt2	89.0805	174	13299	13472	20588	20761	155	19
NC_025457.ref	NC_025457.alt2	98.8304	171	36841	37011	54845	55015	169	2
NC_025457.ref	NC_025457.alt2	98.8166	169	15360	15528	23129	23297	167	2
NC_025457.ref	NC_025457.alt2	98.7805	164	33512	33675	49934	50097	162	2
NC_025457.ref	NC_025457.alt2	85.2761	163	11300	11462	17739	17901	139	24
NC_025457.ref	NC_025457.alt2	92.4051	158	21334	21491	32427	32584	146	12
NC_025457.ref	NC_025457.alt2	87.7419	155	18740	18894	29168	29322	136	19
NC_025457.ref	NC_025457.alt2	90.9091	154	10121	10274	15132	15285	140	14
NC_025457.ref	NC_025457.alt2	96.0784	153	1237	1389	1930	2082	147	6
NC_025457.ref	NC_025457.alt2	1e+02	152	3021	3172	63633	63784	152	0
NC_025457.ref	NC_025457.alt2	88.0795	151	22045	22195	33796	33946	133	18
NC_025457.ref	NC_025457.alt2	95.2703	148	38476	38623	58123	58270	141	7
NC_025457.ref	NC_025457.alt2	92.9078	141	1656	1796	2592	2732	131	10
NC_025457.ref	NC_025457.alt2	89.2857	140	1	140	1	140	125	15
NC_025457.ref	NC_025457.alt2	1e+02	140	33372	33511	49933	49794	140	0
NC_025457.ref	NC_025457.alt2	89.9281	139	15656	15794	23905	24043	125	14
NC_025457.ref	NC_025457.alt2	90.5109	137	9189	9325	13066	13202	124	13
NC_025457.ref	NC_025457.alt2	91.1111	135	5894	6028	8512	8646	123	12
NC_025457.ref	NC_025457.alt2	85.9259	135	25926	26060	39266	39400	116	19
NC_025457.ref	NC_025457.alt2	88.1481	135	34416	34550	51451	51585	119	16
NC_025457.ref	NC_025457.alt2	90.6977	129	39506	39634	59217	59345	117	12
NC_025457.ref	NC_025457.alt2	87.4016	127	817	943	1100	1226	111	16
NC_025457.ref	NC_025457.alt2	86.4	125	29144	29268	43858	44000	108	17
NC_025457.ref	NC_025457.alt2	1e+02	119	26061	26179	39518	39400	119	0
NC_025457.ref	NC_025457.alt2	1e+02	119	32125	32243	17903	18021	119	0
NC_025457.ref	NC_025457.alt2	88.1356	118	18622	18739	28815	28932	104	14
NC_025457.ref	NC_025457.alt2	1e+02	117	29027	29143	43656	43772	117	0
NC_025457.ref	NC_025457.alt2	1e+02	116	23197	23312	23900	23785	116	0
NC_025457.ref	NC_025457.alt2	1e+02	114	39091	39204	58794	58681	114	0
NC_025457.ref	NC_025457.alt2	89.2857	112	5779	5890	8200	8336	100	12
NC_025457.ref	NC_025457.alt2	90.1786	112	31214	31325	47042	47153	101	11
NC_025457.ref	NC_025457.alt2	89.2857	112	31510	31621	47504	47615	100	12
NC_025457.ref	NC_025457.alt2	94.3925	107	26814	26920	40498	40373	101	6
NC_025457.ref	NC_025457.alt2	1e+02	106	19719	19824	56695	56800	106	0
NC_025457.ref	NC_025457.alt2	89.6226	106	29462	29567	44381	44486	95	11
NC_025457.ref	NC_025457.alt2	91.4286	105	13473	13577	20894	20998	96	9
NC_025457.ref	NC_025457.alt2	92.1569	102	15553	15654	23686	23787	94	8
NC_025457.ref	NC_025457.alt2	92.1569	102	33230	33331	33401	33265	94	8
NC_025457.ref	NC_025457.alt2	1e+02	101	22698	22798	34627	34527	101	0
NC_025457.ref	NC_025457.alt2	85	100	4994	5093	7002	7108	85	15
NC_025457.ref	NC_025457.alt2	79.7980	99	16953	17051	26147	26254	79	20
NC_025457.ref	NC_025457.alt2	88.7755	98	38624	38721	58356	58453	87	11
NC_025457.ref	NC_025457.alt2	89.6907	97	33131	33227	49454	49550	87	10
NC_025457.ref	NC_025457.alt2	1e+02	96	29568	29663	44572	44477	96	0
NC_025457.ref	NC_025457.alt2	89.5833	96	37572	37667	56264	56359	86	10
NC_025457.ref	NC_025457.alt2	1e+02	94	18895	18988	54197	54104	94	0
NC_025457.ref	NC_025457.alt2	89.3617	94	38379	38472	57840	57933	84	10
NC_025457.ref	NC_025457.alt2	94.6237	93	18529	18621	28614	28706	88	5
NC_025457.ref	NC_025457.alt2	91.3043	92	9329	9420	13336	13427	84	8
NC_025457.ref	NC_025457.alt2	93.3333	90	9472	9561	13672	13787	84	6
NC_025457.ref	NC_025457.alt2	88.5057	87	28698	28784	43000	43086	77	10
NC_025457.ref	NC_025457.alt2	89.5349	86	11463	11548	18022	18107	77	9
NC_025457.ref	NC_025457.alt2	89.5349	86	21772	21857	33233	33318	77	9
NC_025457.ref	NC_025457.alt2	1e+02	85	34796	34880	52202	52118	85	0
NC_025457.ref	NC_025457.alt2	1e+02	84	24268	24351	36752	36669	84	0
NC_025457.ref	NC_025457.alt2	90.3614	83	41246	41328	62417	62499	75	8
NC_025457.ref	NC_025457.alt2	86.5854	82	18991	19072	29325	29406	71	11
NC_025457.ref	NC_025457.alt2	91.4634	82	38297	38378	57699	57780	75	7
NC_025457.ref	NC_025457.alt2	9e+01	80	39011	39090	58601	58680	72	8
NC_025457.ref	NC_025457.alt2	89.0411	73	16410	16482	25147	25219	65	8
NC_025457.ref	NC_025457.alt2	89.5522	67	12056	12122	18996	19062	60	7
NC_025457.ref	NC_025457.alt2	89.0625	64	4930	4993	6725	6788	57	7
NC_025457.ref	NC_025457.alt2	90.1639	61	17479	17539	26968	27028	55	6
NC_025457.ref	NC_025457.alt2	87.9310	58	10278	10335	15459	15516	51	7
NC_025457.ref	NC_025457.alt2	96.4912	57	3173	3229	4197	4253	55	2
NC_025457.ref	NC_025457.alt2	89.4737	57	23843	23899	36125	36213	51	6
NC_025457.ref	NC_025457.alt2	96.4912	57	37491	37547	55893	55949	55	2
NC_025457.ref	NC_025457.alt2	91.0714	56	15834	15889	24279	24334	51	5
NC_025457.ref	NC_025457.alt2	89.0909	55	13880	13934	21497	21551	49	6
NC_025457.ref	NC_025457.alt2	90.5660	53	10644	10696	16301	16353	48	5
NC_025457.ref	NC_025457.alt2	83.0189	53	16483	16535	25329	25381	44	9
NC_025457.ref	NC_025457.alt2	96.2264	53	19666	19718	30208	30260	51	2
NC_025457.ref	NC_025457.alt2	96.2264	53	34743	34795	52065	52117	51	2
NC_025457.ref	NC_025457.alt2	88.2353	51	31111	31161	46651	46701	45	6
NC_025457.ref	NC_025457.alt2	89.7959	49	9421	9469	13484	13532	44	5
NC_025457.ref	NC_025457.alt2	83.6735	49	29664	29712	44583	44631	41	8
NC_025457.ref	NC_025457.alt2	91.8367	49	31162	31210	46831	46879	45	4
NC_025457.ref	NC_025457.alt2	90.9091	44	41199	41242	62217	62260	40	4
NC_025457.ref	NC_025457.alt2	95.4545	44	42611	42654	64121	64164	42	2
NC_025457.ref	NC_025457.alt2	72.5	40	9691	9730	35617	35565	29	11
NC_025457.ref	NC_025457.alt2	82.0513	39	15795	15833	24142	24180	32	7
NC_025457.ref	NC_025457.alt2	94.7368	38	33334	33371	49756	49793	36	2
NC_025457.ref	NC_025457.alt2	91.4286	35	9642	9676	14238	14272	32	3
NC_025457.ref	NC_025457.alt2	97.1429	35	10607	10641	16146	16180	34	1
NC_010807.alt3	NC_010807.alt2	98.6012	3503	8840	12342	9320	12822	3454	49
NC_010807.alt3	NC_010807.alt2	98.7696	2682	30260	32941	31319	34000	2649	33
NC_010807.alt3	NC_010807.alt2	98.9701	2039	20094	22132	20717	22755	2018	21
NC_010807.alt3	NC_010807.alt2	98.3297	1856	26510	28365	27404	29259	1825	31
NC_010807.alt3	NC_010807.alt2	98.6352	1612	1394	3005	1085	2696	1590	22
NC_010807.alt3	NC_010807.alt2	98.9247	1581	38311	39891	38975	40555	1564	17
NC_010807.alt3	NC_010807.alt2	98.4203	1456	22250	23705	22764	24219	1433	23
NC_010807.alt3	NC_010807.alt2	98.4171	1453	17362	18814	17869	19321	1430	23
NC_010807.alt3	NC_010807.alt2	99.0438	1255	15378	16632	15914	17168	1243	12
NC_010807.alt3	NC_010807.alt2	98.3092	1242	24217	25458	24627	25868	1221	21
NC_010807.alt3	NC_010807.alt2	98.0567	1235	3750	4984	3381	4615	1211	24
NC_010807.alt3	NC_010807.alt2	98.7815	1231	33581	34811	34665	35895	1216	15
NC_010807.alt3	NC_010807.alt2	98.6842	1140	4985	6124	4826	5965	1125	15
NC_010807.alt3	NC_010807.alt2	98.2213	1012	12343	13354	12918	13929	994	18
NC_010807.alt3	NC_010807.alt2	97.7949	907	19025	19931	19322	20228	887	20
NC_010807.alt3	NC_010807.alt2	96.7621	803	423	1225	316	1133	777	26
NC_010807.alt3	NC_010807.alt2	98.9276	746	14434	15179	15170	15915	738	8
NC_010807.alt3	NC_010807.alt2	98.8636	704	36380	37083	37149	37852	696	8
NC_010807.alt3	NC_010807.alt2	98.6957	690	8012	8701	8630	9319	681	9
NC_010807.alt3	NC_010807.alt2	98.0882	680	28366	29045	29422	30101	667	13
NC_010807.alt3	NC_010807.alt2	98.6928	612	29046	29657	30194	30805	604	8
NC_010807.alt3	NC_010807.alt2	98.8176	592	7059	7650	7355	7946	585	7
NC_010807.alt3	NC_010807.alt2	98.9362	564	13870	14433	14513	15107	558	6
NC_010807.alt3	NC_010807.alt2	99.1007	556	25459	26014	26146	26701	551	5
NC_010807.alt3	NC_010807.alt2	98.7203	547	16633	17179	17324	17870	540	7
NC_010807.alt3	NC_010807.alt2	99.2278	518	35648	36165	36629	37146	514	4
NC_010807.alt3	NC_010807.alt2	98.9899	495	26015	26509	26811	27305	490	5
NC_010807.alt3	NC_010807.alt2	98.9451	474	13355	13828	14041	14514	469	5
NC_010807.alt3	NC_010807.alt2	98.4581	454	34910	35363	35896	36349	447	7
NC_010807.alt3	NC_010807.alt2	99.0610	426	6127	6552	6243	6668	422	4
NC_010807.alt3	NC_010807.alt2	99.5098	408	33173	33580	34143	34550	406	2
NC_010807.alt3	NC_010807.alt2	97.8320	369	37757	38125	38261	38629	361	8
NC_010807.alt3	NC_010807.alt2	1e+02	361	7651	8011	8159	8519	361	0
NC_010807.alt3	NC_010807.alt2	99.3865	326	29934	30259	30807	31132	324	2
NC_010807.alt3	NC_010807.alt2	99.6454	282	3342	3623	26143	25862	281	1
NC_010807.alt3	NC_010807.alt2	1e+02	277	6676	6952	7078	7354	277	0
NC_010807.alt3	NC_010807.alt2	99.6377	276	29658	29933	38974	38699	275	1
NC_010807.alt3	NC_010807.alt2	1e+02	236	37293	37528	38025	38260	236	0
NC_010807.alt3	NC_010807.alt2	98.6842	228	37529	37756	20219	20446	225	3
NC_010807.alt3	NC_010807.alt2	99.0566	212	36168	36379	8158	7947	210	2
NC_010807.alt3	NC_010807.alt2	99.0476	210	18815	19024	3370	3161	208	2
NC_010807.alt3	NC_010807.alt2	99.0431	209	37084	37292	4819	4611	207	2
NC_010807.alt3	NC_010807.alt2	99.4536	183	1	183	1	183	182	1
NC_010807.alt3	NC_010807.alt2	99.4286	175	3167	3341	2696	2870	174	1
NC_010807.alt3	NC_010807.alt2	97.7011	174	35474	35647	36349	36522	170	4
NC_010807.alt3	NC_010807.alt2	99.3865	163	23948	24110	24456	24618	162	1
NC_010807.alt3	NC_010807.alt2	1e+02	162	19932	20093	20457	20618	162	0
NC_010807.alt3	NC_010807.alt2	97.5	160	3006	3165	29261	29420	156	4
NC_010807.alt3	NC_010807.alt2	99.3056	144	23709	23852	24312	24455	143	1
NC_010807.alt3	NC_010807.alt2	99.2754	138	8702	8839	6806	6669	137	1
NC_010807.alt3	NC_010807.alt2	97.6190	126	3624	3749	3045	3170	123	3
NC_010807.alt3	NC_010807.alt2	99.1870	123	6553	6675	6807	6929	122	1
NC_010807.alt3	NC_010807.alt2	98.2906	117	22133	22249	26810	26694	115	2
NC_010807.alt3	NC_010807.alt2	1e+02	115	38126	38240	6239	6125	115	0
NC_010807.alt3	NC_010807.alt2	98.1818	110	35364	35473	13931	14040	108	2
NC_010807.alt3	NC_010807.alt2	94.3396	106	24111	24216	20619	20724	100	6
NC_010807.alt3	NC_010807.alt2	1e+02	103	6956	7058	36526	36628	103	0
NC_010807.alt3	NC_010807.alt2	98.9796	98	34812	34909	27306	27403	97	1
NC_010807.alt3	NC_010807.alt2	98.9474	95	23853	23947	12822	12916	94	1
NC_010807.alt3	NC_010807.alt2	1e+02	70	38241	38310	38630	38699	70	0
NC_010807.ref	NC_010807.alt1	99.8399	7494	24883	32376	24883	32376	7482	12
NC_010807.ref	NC_010807.alt1	99.7003	6339	32477	38815	32477	38815	6320	19
NC_010807.ref	NC_010807.alt1	99.7788	5425	19341	24765	19341	24765	5413	12
NC_010807.ref	NC_010807.alt1	99.4305	3336	7521	10856	6895	10230	3317	19
NC_010807.ref	NC_010807.alt1	99.8184	2753	12113	14865	11551	14303	2748	5
NC_010807.ref	NC_010807.alt1	99.7668	2573	3255	5827	2629	5201	2567	6
NC_010807.ref	NC_010807.alt1	99.7616	2097	15794	17890	15678	17774	2092	5
NC_010807.ref	NC_010807.alt1	99.7076	2052	1023	3074	577	2628	2046	6
NC_010807.ref	NC_010807.alt1	99.5918	1470	5949	7418	5323	6792	1464	6
NC_010807.ref	NC_010807.alt1	99.7039	1351	17990	19340	17874	19224	1347	4
NC_010807.ref	NC_010807.alt1	99.8252	1144	10969	12112	10227	11370	1142	2
NC_010807.ref	NC_010807.alt1	1e+02	928	14866	15793	14588	15515	928	0
NC_010807.ref	NC_010807.alt1	1e+02	468	393	860	109	576	468	0
NC_010807.ref	NC_010807.alt1	1e+02	230	1	230	38586	38815	230	0
NC_010807.ref	NC_010807.alt1	1e+02	180	3075	3254	11371	11550	180	0
NC_010807.ref	NC_010807.alt1	1e+02	162	231	392	14465	14304	162	0
NC_010807.ref	NC_010807.alt1	1e+02	162	861	1022	15516	15677	162	0
NC_010807.ref	NC_010807.alt1	1e+02	121	5828	5948	5322	5202	121	0
NC_010807.ref	NC_010807.alt1	98.2906	117	24766	24882	24873	24757	115	2
NC_010807.ref	NC_010807.alt1	1e+02	112	10857	10968	19335	19224	112	0
NC_010807.ref	NC_010807.alt1	1e+02	102	7419	7520	6894	6793	102	0
NC_010807.ref	NC_010807.alt1	1e+02	100	32377	32476	32475	32376	100	0
NC_010807.ref	NC_010807.alt1	1e+02	99	17891	17989	17872	17774	99	0
NC_025457.alt1	NC_010807.ref	49.6241	133	27917	28049	19578	19816	66	67
NC_025457.alt1	NC_010807.ref	44.4444	81	9580	9660	17022	17125	36	45
NC_025457.alt1	NC_010807.ref	58.75	80	29152	29231	11546	11691	47	33
NC_025457.alt1	NC_010807.ref	54.5455	66	3893	3958	26271	26180	36	30
NC_025457.alt1	NC_010807.ref	53.9683	63	40274	40336	3708	3623	34	29
NC_025457.alt1	NC_010807.ref	48.3871	62	24892	24953	32367	32461	30	32
NC_025457.alt1	NC_010807.ref	55.7377	61	5921	5981	30751	30669	34	27
NC_025457.alt1	NC_010807.ref	56.8966	58	4918	4975	27191	27111	33	25
NC_025457.alt1	NC_010807.ref	34.4828	58	15346	15403	12049	12000	20	38
NC_025457.alt1	NC_010807.ref	53.4483	58	38882	38939	25143	25233	31	27
NC_025457.alt1	NC_010807.ref	53.5714	56	21531	21586	28279	28349	30	26
NC_025457.alt1	NC_010807.ref	41.8182	55	31873	31927	17087	17132	23	32
NC_025457.alt1	NC_010807.ref	62.9630	54	11255	11308	37482	37532	34	20
NC_025457.alt1	NC_010807.ref	48.0769	52	38006	38057	22718	22757	25	27
NC_025457.alt1	NC_010807.ref	46	50	23677	23726	34289	34331	23	27
NC_025457.alt1	NC_010807.ref	48.9362	47	13234	13280	1016	1051	23	24
NC_025457.alt1	NC_010807.ref	61.7021	47	31026	31072	19183	19252	29	18
NC_025457.alt1	NC_010807.ref	63.0435	46	27464	27509	17215	17248	29	17
NC_025457.alt1	NC_010807.ref	55.5556	45	17487	17531	18640	18677	25	20
NC_025457.alt1	NC_010807.ref	76.7442	43	16917	16959	677	718	33	10
NC_025457.alt1	NC_010807.ref	65.8537	41	33058	33098	17992	17937	27	14
NC_025457.alt1	NC_010807.ref	65	40	30792	30831	7975	8009	26	14
NC_025457.alt1	NC_010807.ref	62.5	40	34705	34744	22616	22674	25	15
NC_025457.alt1	NC_010807.ref	69.2308	39	6847	6885	14507	14580	27	12
NC_025457.alt1	NC_010807.ref	69.4444	36	15086	15121	20982	21016	25	11
NC_025457.alt1	NC_010807.ref	58.3333	36	22002	22037	1702	1739	21	15
NC_025457.alt1	NC_010807.alt3	50.5618	89	14429	14517	24514	24424	45	44
NC_025457.alt1	NC_010807.alt3	44.4444	81	9580	9660	17459	17562	36	45
NC_025457.alt1	NC_010807.alt3	6e+01	80	29152	29231	11762	11907	48	32
NC_025457.alt1	NC_010807.alt3	54.5455	66	3893	3958	26508	26417	36	30
NC_025457.alt1	NC_010807.alt3	53.9683	63	40274	40336	4355	4270	34	29
NC_025457.alt1	NC_010807.alt3	48.3871	62	24892	24953	32619	32713	30	32
NC_025457.alt1	NC_010807.alt3	62.9032	62	27917	27978	19997	20091	39	23
NC_025457.alt1	NC_010807.alt3	55.7377	61	5921	5981	31003	30921	34	27
NC_025457.alt1	NC_010807.alt3	56.8966	58	4918	4975	27330	27250	33	25
NC_025457.alt1	NC_010807.alt3	53.4483	58	10518	10575	345	275	31	27
NC_025457.alt1	NC_010807.alt3	34.4828	58	15346	15403	12265	12216	20	38
NC_025457.alt1	NC_010807.alt3	53.4483	58	38882	38939	25489	25579	31	27
NC_025457.alt1	NC_010807.alt3	54.3860	57	33557	33613	25294	25210	31	26
NC_025457.alt1	NC_010807.alt3	53.5714	56	21531	21586	3057	3127	30	26
NC_025457.alt1	NC_010807.alt3	58.1818	55	22825	22879	26486	26537	32	23
NC_025457.alt1	NC_010807.alt3	41.8182	55	31873	31927	17524	17569	23	32
NC_025457.alt1	NC_010807.alt3	62.9630	54	11255	11308	38558	38608	34	20
NC_025457.alt1	NC_010807.alt3	46	50	23677	23726	34772	34814	23	27
NC_025457.alt1	NC_010807.alt3	63.0435	46	27464	27509	17652	17685	29	17
NC_025457.alt1	NC_010807.alt3	55.5556	45	17487	17531	19287	19324	25	20
NC_025457.alt1	NC_010807.alt3	76.7442	43	16917	16959	893	934	33	10
NC_025457.alt1	NC_010807.alt3	65.8537	41	33058	33098	18429	18374	27	14
NC_025457.alt1	NC_010807.alt3	65	40	30792	30831	8053	8087	26	14
NC_025457.alt1	NC_010807.alt3	62.5	40	34705	34744	23046	23104	25	15
NC_025457.alt1	NC_010807.alt3	69.4444	36	15086	15121	21303	21337	25	11
NC_025457.alt1	NC_010807.alt3	58.3333	36	22002	22037	2120	2157	21	15
NC_010807.alt3	NC_005091.ref	53.9474	76	16875	16950	20995	21083	41	35
NC_010807.alt3	NC_005091.ref	61.8421	76	28519	28594	17715	17812	47	29
NC_010807.alt3	NC_005091.ref	58.4615	65	27877	27941	31486	31433	38	27
NC_010807.alt3	NC_005091.ref	39.0625	64	24970	25033	50075	50020	25	39
NC_010807.alt3	NC_005091.ref	59.6774	62	21276	21337	48484	48411	37	25
NC_010807.alt3	NC_005091.ref	50.8772	57	30207	30263	33320	33280	29	28
NC_010807.alt3	NC_005091.ref	46.4286	56	2923	2978	56071	56115	26	30
NC_010807.alt3	NC_005091.ref	46.4286	56	23809	23864	24427	24520	26	30
NC_010807.alt3	NC_005091.ref	41.8182	55	20036	20090	42608	42565	23	32
NC_010807.alt3	NC_005091.ref	61.1111	54	4252	4305	51521	51441	33	21
NC_010807.alt3	NC_005091.ref	66.6667	54	30759	30812	38152	38212	36	18
NC_010807.alt3	NC_005091.ref	51.8519	54	31498	31551	53778	53736	28	26
NC_010807.alt3	NC_005091.ref	48.0769	52	22454	22505	16680	16752	25	27
NC_010807.alt3	NC_005091.ref	62.7451	51	19544	19594	39509	39470	32	19
NC_010807.alt3	NC_005091.ref	61.2245	49	10244	10292	4343	4300	30	19
NC_010807.alt3	NC_005091.ref	53.0612	49	22526	22574	30089	30133	26	23
NC_010807.alt3	NC_005091.ref	66.6667	48	14391	14438	2959	3024	32	16
NC_010807.alt3	NC_005091.ref	64.5833	48	31923	31970	47085	47170	31	17
NC_010807.alt3	NC_005091.ref	55.3191	47	11026	11072	20261	20194	26	21
NC_010807.alt3	NC_005091.ref	68.0851	47	11073	11119	46522	46437	32	15
NC_010807.alt3	NC_005091.ref	55.3191	47	17547	17593	36721	36687	26	21
NC_010807.alt3	NC_005091.ref	62.2222	45	19150	19194	9129	9194	28	17
NC_010807.alt3	NC_005091.ref	56.8182	44	31988	32031	27791	27821	25	19
NC_010807.alt3	NC_005091.ref	66.6667	42	6853	6894	42608	42671	28	14
NC_010807.alt3	NC_005091.ref	61.9048	42	21201	21242	53075	52995	26	16
NC_010807.alt3	NC_005091.ref	64.2857	42	36984	37025	32689	32621	27	15
NC_010807.alt3	NC_005091.ref	60.9756	41	22179	22219	24650	24583	25	16
NC_010807.alt3	NC_005091.ref	60.9756	41	25422	25462	13260	13184	25	16
NC_010807.alt3	NC_005091.ref	62.5	40	1958	1997	6605	6561	25	15
NC_010807.alt3	NC_005091.ref	65	40	16063	16102	19770	19692	26	14
NC_010807.alt3	NC_005091.ref	69.4444	36	1379	1414	52915	52977	25	11
NC_010807.alt3	NC_005091.ref	69.4444	36	8172	8207	32845	32903	25	11
NC_010807.alt3	NC_005091.ref	75	36	11442	11477	34805	34758	27	9
NC_010807.alt3	NC_005091.ref	66.6667	36	37678	37713	50324	50297	24	12
NC_010807.alt3	NC_005091.ref	71.4286	35	24713	24747	26910	26950	25	10
NC_025457.ref	NC_025457.alt1	99.6618	1774	17563	19336	16668	18441	1768	6
NC_025457.ref	NC_025457.alt1	98.5521	1036	20977	22012	19782	20817	1021	15
NC_025457.ref	NC_025457.alt1	99.3521	926	36129	37054	34425	35350	920	6
NC_025457.ref	NC_025457.alt1	99.6556	871	32507	33377	31348	32218	868	3
NC_025457.ref	NC_025457.alt1	99.5397	869	37055	37923	35447	36315	865	4
NC_025457.ref	NC_025457.alt1	95.7816	806	35064	35869	33192	33958	772	34
NC_025457.ref	NC_025457.alt1	99.3781	804	16584	17387	15865	16668	799	5
NC_025457.ref	NC_025457.alt1	99.8737	792	25518	26309	24145	24936	791	1
NC_025457.ref	NC_025457.alt1	99.3590	780	709	1488	547	1360	775	5
NC_025457.ref	NC_025457.alt1	99.5775	710	41580	42289	39800	40509	707	3
NC_025457.ref	NC_025457.alt1	99.2571	673	19892	20564	18593	19282	668	5
NC_025457.ref	NC_025457.alt1	98.9442	663	5464	6126	4979	5641	656	7
NC_025457.ref	NC_025457.alt1	99.5261	633	22695	23327	21470	22102	630	3
NC_025457.ref	NC_025457.alt1	98.5646	627	2663	3289	2460	3077	618	9
NC_025457.ref	NC_025457.alt1	98.9865	592	7756	8347	7453	8044	586	6
NC_025457.ref	NC_025457.alt1	99.4932	592	30084	30675	28894	29485	589	3
NC_025457.ref	NC_025457.alt1	99.4545	550	1	550	1	550	547	3
NC_025457.ref	NC_025457.alt1	95.8416	505	23937	24441	23009	23484	484	21
NC_025457.ref	NC_025457.alt1	99.1525	472	31358	31829	30325	30796	468	4
NC_025457.ref	NC_025457.alt1	99.1471	469	6722	7190	6022	6490	465	4
NC_025457.ref	NC_025457.alt1	99.5652	460	14573	15032	14136	14595	458	2
NC_025457.ref	NC_025457.alt1	98.9130	460	27827	28286	26850	27322	455	5
NC_025457.ref	NC_025457.alt1	98.8938	452	30906	31357	29629	30109	447	5
NC_025457.ref	NC_025457.alt1	99.3318	449	13385	13833	12636	13084	446	3
NC_025457.ref	NC_025457.alt1	99.7743	443	28367	28809	27323	27765	442	1
NC_025457.ref	NC_025457.alt1	99.2891	422	12900	13321	12133	12554	419	3
NC_025457.ref	NC_025457.alt1	99.2806	417	9989	10405	9560	9976	414	3
NC_025457.ref	NC_025457.alt1	98.4615	390	29028	29417	27766	28155	384	6
NC_025457.ref	NC_025457.alt1	97.8836	378	39309	39686	37692	38054	370	8
NC_025457.ref	NC_025457.alt1	97.4286	350	1499	1848	1617	1962	341	9
NC_025457.ref	NC_025457.alt1	1e+02	349	10690	11038	10276	10624	349	0
NC_025457.ref	NC_025457.alt1	99.7050	339	26310	26648	25127	25465	338	1
NC_025457.ref	NC_025457.alt1	99.7041	338	32052	32389	31011	31348	337	1
NC_025457.ref	NC_025457.alt1	1e+02	327	9521	9847	8861	9187	327	0
NC_025457.ref	NC_025457.alt1	99.3769	321	8350	8670	8157	8477	319	2
NC_025457.ref	NC_025457.alt1	95.7655	307	3994	4300	3555	3846	294	13
NC_025457.ref	NC_025457.alt1	97.7199	307	9214	9520	8496	8802	300	7
NC_025457.ref	NC_025457.alt1	99.3355	301	40150	40450	38169	38469	299	2
NC_025457.ref	NC_025457.alt1	99.6599	294	13881	14174	13435	13728	293	1
NC_025457.ref	NC_025457.alt1	96.0854	281	24877	25157	23574	23844	270	11
NC_025457.ref	NC_025457.alt1	1e+02	271	38298	38568	36575	36845	271	0
NC_025457.ref	NC_025457.alt1	96.5251	259	35870	36128	34125	34366	250	9
NC_025457.ref	NC_025457.alt1	98.4436	257	1861	2117	2079	2335	253	4
NC_025457.ref	NC_025457.alt1	97.6	250	22445	22694	21056	21305	244	6
NC_025457.ref	NC_025457.alt1	99.5984	249	12651	12899	11752	12000	248	1
NC_025457.ref	NC_025457.alt1	97.9757	247	11399	11645	10716	10962	242	5
NC_025457.ref	NC_025457.alt1	98.3740	246	34618	34863	32959	33234	242	4
NC_025457.ref	NC_025457.alt1	99.5868	242	7300	7541	6740	6981	241	1
NC_025457.ref	NC_025457.alt1	99.1667	240	41126	41365	38986	39225	238	2
NC_025457.ref	NC_025457.alt1	97.8723	235	15276	15510	14596	14830	230	5
NC_025457.ref	NC_025457.alt1	99.1453	234	40786	41019	38752	38985	232	2
NC_025457.ref	NC_025457.alt1	98.6957	230	11799	12028	11170	11399	227	3
NC_025457.ref	NC_025457.alt1	92.9825	228	14175	14402	13781	13984	212	16
NC_025457.ref	NC_025457.alt1	99.0521	211	26838	27048	25755	25965	209	2
NC_025457.ref	NC_025457.alt1	99.5169	207	4444	4650	3847	4053	206	1
NC_025457.ref	NC_025457.alt1	98.9796	196	16026	16221	15242	15437	194	2
NC_025457.ref	NC_025457.alt1	96.8912	193	10497	10689	9977	10169	187	6
NC_025457.ref	NC_025457.alt1	98.4043	188	33984	34171	32695	32882	185	3
NC_025457.ref	NC_025457.alt1	1e+02	176	23372	23547	22101	22276	176	0
NC_025457.ref	NC_025457.alt1	1e+02	174	26649	26822	25583	25756	174	0
NC_025457.ref	NC_025457.alt1	95.8333	168	5296	5463	4447	4614	161	7
NC_025457.ref	NC_025457.alt1	1e+02	162	15864	16025	14941	15102	162	0
NC_025457.ref	NC_025457.alt1	96.875	160	3449	3608	3078	3335	155	5
NC_025457.ref	NC_025457.alt1	1e+02	159	12299	12457	11594	11752	159	0
NC_025457.ref	NC_025457.alt1	95.5696	158	40491	40648	38457	38614	151	7
NC_025457.ref	NC_025457.alt1	97.4522	157	16427	16583	15856	15700	153	4
NC_025457.ref	NC_025457.alt1	1e+02	143	3609	3751	3294	3436	143	0
NC_025457.ref	NC_025457.alt1	1e+02	143	12029	12171	11451	11593	143	0
NC_025457.ref	NC_025457.alt1	99.3007	143	27219	27361	26374	26516	142	1
NC_025457.ref	NC_025457.alt1	1e+02	138	42517	42654	40929	41066	138	0
NC_025457.ref	NC_025457.alt1	1e+02	137	40649	40785	38750	38614	137	0
NC_025457.ref	NC_025457.alt1	1e+02	136	23548	23683	22411	22546	136	0
NC_025457.ref	NC_025457.alt1	1e+02	135	23684	23818	22681	22547	135	0
NC_025457.ref	NC_025457.alt1	1e+02	135	31917	32051	30796	30930	135	0
NC_025457.ref	NC_025457.alt1	99.2593	135	37924	38058	36442	36576	134	1
NC_025457.ref	NC_025457.alt1	92.5926	135	41431	41565	39688	39816	125	10
NC_025457.ref	NC_025457.alt1	99.2481	133	2290	2422	2336	2504	132	1
NC_025457.ref	NC_025457.alt1	99.2366	131	25295	25425	24015	24145	130	1
NC_025457.ref	NC_025457.alt1	83.8462	130	11136	11265	10618	10724	109	21
NC_025457.ref	NC_025457.alt1	92.8571	126	24610	24735	23481	23645	117	9
NC_025457.ref	NC_025457.alt1	99.1935	124	6268	6391	5641	5764	123	1
NC_025457.ref	NC_025457.alt1	99.1803	122	27362	27483	26726	26847	121	1
NC_025457.ref	NC_025457.alt1	1e+02	122	38603	38724	36845	36998	122	0
NC_025457.ref	NC_025457.alt1	99.1525	118	23819	23936	22682	22799	117	1
NC_025457.ref	NC_025457.alt1	99.1379	116	39892	40007	38053	38168	115	1
NC_025457.ref	NC_025457.alt1	1e+02	116	42290	42405	40623	40508	116	0
NC_025457.ref	NC_025457.alt1	1e+02	113	22332	22444	20872	20984	113	0
NC_025457.ref	NC_025457.alt1	99.1150	113	29931	30043	28418	28530	112	1
NC_025457.ref	NC_025457.alt1	1e+02	112	15739	15850	14831	14942	112	0
NC_025457.ref	NC_025457.alt1	1e+02	109	7191	7299	6545	6653	109	0
NC_025457.ref	NC_025457.alt1	93.5185	108	25187	25294	23841	23948	101	7
NC_025457.ref	NC_025457.alt1	1e+02	106	29418	29523	28265	28370	106	0
NC_025457.ref	NC_025457.alt1	1e+02	105	5191	5295	4441	4337	105	0
NC_025457.ref	NC_025457.alt1	1e+02	103	39206	39308	37690	37588	103	0
NC_025457.ref	NC_025457.alt1	97.9592	98	4904	5001	4174	4271	96	2
NC_025457.ref	NC_025457.alt1	1e+02	90	38725	38814	37242	37331	90	0
NC_025457.ref	NC_025457.alt1	98.8764	89	39117	39205	37500	37588	88	1
NC_025457.ref	NC_025457.alt1	1e+02	88	38815	38902	37413	37500	88	0
NC_025457.ref	NC_025457.alt1	98.8235	85	14488	14572	13985	14069	84	1
NC_025457.ref	NC_025457.alt1	96.4286	84	7542	7625	7051	7134	81	3
NC_025457.ref	NC_025457.alt1	94.0476	84	42406	42489	40626	40709	79	5
NC_025457.ref	NC_025457.alt1	1e+02	78	19646	19723	18515	18592	78	0
NC_025457.ref	NC_025457.alt1	1e+02	78	34351	34428	32882	32959	78	0
NC_025457.ref	NC_025457.alt1	1e+02	76	19468	19543	18442	18517	76	0
NC_025457.ref	NC_025457.alt1	1e+02	75	5116	5190	4267	4341	75	0
NC_025457.ref	NC_025457.alt1	96	75	20710	20784	19257	19331	72	3
NC_025457.ref	NC_025457.alt1	1e+02	73	33378	33450	32374	32446	73	0
NC_025457.ref	NC_025457.alt1	92.8571	70	33614	33683	32436	32505	65	5
NC_025457.ref	NC_025457.alt1	98.5507	69	33915	33983	32506	32574	68	1
NC_025457.ref	NC_025457.alt1	1e+02	65	41366	41430	39475	39539	65	0
NC_025457.ref	NC_025457.alt1	67.2131	61	565	625	10841	10902	41	20
NC_025457.ref	NC_025457.alt1	55.7377	61	20595	20655	14333	14399	34	27
NC_025457.ref	NC_025457.alt1	57.1429	56	27695	27750	34684	34733	32	24
NC_025457.ref	NC_025457.alt1	65.4545	55	20913	20967	35299	35385	36	19
NC_025457.ref	NC_025457.alt1	1e+02	54	22085	22138	20818	20871	54	0
NC_025457.ref	NC_025457.alt1	55.7692	52	29877	29928	32753	32793	29	23
NC_025457.ref	NC_025457.alt1	1e+02	51	29713	29763	28368	28418	51	0
NC_025457.ref	NC_025457.alt1	66	50	22015	22064	3793	3873	33	17
NC_025457.ref	NC_025457.alt1	1e+02	47	13834	13880	13234	13280	47	0
NC_025457.ref	NC_025457.alt1	1e+02	47	27084	27130	26329	26375	47	0
NC_025457.ref	NC_025457.alt1	55.3191	47	38121	38167	40959	40923	26	21
NC_025457.ref	NC_025457.alt1	58.6957	46	3389	3434	14230	14152	27	19
NC_025457.ref	NC_025457.alt1	71.7391	46	9032	9077	3599	3691	33	13
NC_025457.ref	NC_025457.alt1	1e+02	45	16382	16426	15663	15707	45	0
NC_025457.ref	NC_025457.alt1	93.3333	45	30861	30905	29481	29525	42	3
NC_025457.ref	NC_025457.alt1	95	40	30044	30083	28741	28780	38	2
NC_025457.ref	NC_025457.alt1	1e+02	35	27049	27083	26101	26135	35	0
NC_010807.alt1	NC_010807.alt2	98.5667	4186	24883	29068	25916	30101	4126	60
NC_010807.alt1	NC_010807.alt2	98.7297	3936	19340	23275	20284	24219	3886	50
NC_010807.alt1	NC_010807.alt2	98.8912	3337	33098	36434	34665	38001	3300	37
NC_010807.alt1	NC_010807.alt2	98.3921	2923	7308	10230	8630	11552	2876	47
NC_010807.alt1	NC_010807.alt2	98.4065	2573	2629	5201	3533	6105	2532	41
NC_010807.alt1	NC_010807.alt2	98.7820	2381	36435	38815	38175	40555	2352	29
NC_010807.alt1	NC_010807.alt2	99.1558	2369	30008	32376	31319	33687	2349	20
NC_010807.alt1	NC_010807.alt2	98.7213	2268	11551	13818	12809	15107	2239	29
NC_010807.alt1	NC_010807.alt2	98.5769	1827	577	2403	1132	2958	1801	26
NC_010807.alt1	NC_010807.alt2	98.4778	1511	16264	17774	17324	18834	1488	23
NC_010807.alt1	NC_010807.alt2	98.6550	1487	23279	24765	24312	25798	1467	20
NC_010807.alt1	NC_010807.alt2	98.3716	1351	17874	19224	18934	20284	1329	22
NC_010807.alt1	NC_010807.alt2	98.6842	1140	10231	11370	11669	12808	1125	15
NC_010807.alt1	NC_010807.alt2	98.9350	939	29069	30007	30194	31132	929	10
NC_010807.alt1	NC_010807.alt2	99.3534	928	14588	15515	15655	16582	922	6
NC_010807.alt1	NC_010807.alt2	98.5976	927	5866	6792	7078	8004	914	13
NC_010807.alt1	NC_010807.alt2	99.1468	586	15678	16263	16583	17168	581	5
NC_010807.alt1	NC_010807.alt2	99.4475	543	5323	5865	6387	6929	540	3
NC_010807.alt1	NC_010807.alt2	98.9691	485	13819	14303	15170	15654	480	5
NC_010807.alt1	NC_010807.alt2	99.1453	468	109	576	502	969	464	4
NC_010807.alt1	NC_010807.alt2	99.2736	413	6895	7307	8107	8519	410	3
NC_010807.alt1	NC_010807.alt2	99.1045	335	32763	33097	34216	34550	332	3
NC_010807.alt1	NC_010807.alt2	98.2517	286	32477	32762	33788	34073	281	5
NC_010807.alt1	NC_010807.alt2	99.2958	284	14304	14587	501	218	282	2
NC_010807.alt1	NC_010807.alt2	99.1111	225	2404	2628	3128	3352	223	2
NC_010807.alt1	NC_010807.alt2	98.3333	180	11371	11550	3353	3532	177	3
NC_010807.alt1	NC_010807.alt2	1e+02	162	15516	15677	970	1131	162	0
NC_010807.alt1	NC_010807.alt2	98.3471	121	5202	5322	6386	6266	119	2
NC_010807.alt1	NC_010807.alt2	97.4359	117	24766	24882	25906	25790	114	3
NC_010807.alt1	NC_010807.alt2	96.5217	115	19225	19339	11663	11549	111	4
NC_010807.alt1	NC_010807.alt2	99.0741	108	1	108	1	108	107	1
NC_010807.alt1	NC_010807.alt2	99.0196	102	6793	6894	8106	8005	101	1
NC_010807.alt1	NC_010807.alt2	96	100	32377	32476	33786	33687	96	4
NC_010807.alt1	NC_010807.alt2	97.9798	99	17775	17873	18932	18834	97	2
NC_010807.alt2	NC_010807.ref	98.8796	7051	17169	24219	16225	23275	6972	79
NC_010807.alt2	NC_010807.ref	98.9149	6543	8520	15062	7824	14366	6472	71
NC_010807.alt2	NC_010807.ref	98.7589	5882	24220	30101	23187	29068	5809	73
NC_010807.alt2	NC_010807.ref	99.1597	3451	34551	38001	32984	36434	3422	29
NC_010807.alt2	NC_010807.ref	98.7314	3153	2959	6111	2681	5833	3113	40
NC_010807.alt2	NC_010807.ref	99.1840	2941	31133	34073	29822	32762	2917	24
NC_010807.alt2	NC_010807.ref	99.0631	2775	184	2958	75	2849	2749	26
NC_010807.alt2	NC_010807.ref	99.1386	2554	38002	40555	36262	38815	2532	22
NC_010807.alt2	NC_010807.ref	99.2877	2106	15063	17168	14274	16379	2091	15
NC_010807.alt2	NC_010807.ref	99.4969	1590	6930	8519	6344	7933	1582	8
NC_010807.alt2	NC_010807.ref	99.1271	1031	30102	31132	28977	30007	1022	9
NC_010807.alt2	NC_010807.ref	99.3888	818	6112	6929	5674	6491	813	5
NC_010807.alt2	NC_010807.ref	99.5807	477	34074	34550	32621	33097	475	2
NC_010807.alt2	NC_010807.ref	1e+02	183	1	183	1	183	183	0
NC_010807.alt1	NC_002486.alt	41.1765	68	36448	36515	29989	30045	28	40
NC_010807.alt1	NC_002486.alt	70.3125	64	12490	12553	25560	25664	45	19
NC_010807.alt1	NC_002486.alt	53.2258	62	27238	27299	43842	43790	33	29
NC_010807.alt1	NC_002486.alt	5e+01	58	5303	5360	22616	22568	29	29
NC_010807.alt1	NC_002486.alt	44.8276	58	24500	24557	24927	24975	26	32
NC_010807.alt1	NC_002486.alt	56.8966	58	34843	34900	36838	36909	33	25
NC_010807.alt1	NC_002486.alt	48.0769	52	20679	20730	6147	6188	25	27
NC_010807.alt1	NC_002486.alt	54.9020	51	15368	15418	28769	28727	28	23
NC_010807.alt1	NC_002486.alt	40.8163	49	6629	6677	21638	21599	20	29
NC_010807.alt1	NC_002486.alt	69.3878	49	34622	34670	19444	19345	34	15
NC_010807.alt1	NC_002486.alt	62.5	48	13304	13351	43666	43749	30	18
NC_010807.alt1	NC_002486.alt	66.6667	48	15702	15749	3685	3649	32	16
NC_010807.alt1	NC_002486.alt	48.9362	47	29464	29510	12212	12175	23	24
NC_010807.alt1	NC_002486.alt	40.4255	47	32838	32884	2607	2646	19	28
NC_010807.alt1	NC_002486.alt	66.6667	45	21186	21230	23804	23727	30	15
NC_010807.alt1	NC_002486.alt	47.6190	42	8676	8717	38285	38318	20	22
NC_010807.alt1	NC_002486.alt	69.0476	42	28313	28354	2465	2519	29	13
NC_010807.alt1	NC_002486.alt	6e+01	40	24901	24940	39502	39539	24	16
NC_010807.alt1	NC_002486.alt	71.7949	39	23450	23488	40930	40977	28	11
NC_010807.alt1	NC_002486.ref	41.1765	68	36448	36515	15648	15592	28	40
NC_010807.alt1	NC_002486.ref	70.3125	64	12490	12553	20077	19973	45	19
NC_010807.alt1	NC_002486.ref	53.2258	62	27238	27299	13418	13366	33	29
NC_010807.alt1	NC_002486.ref	5e+01	58	5303	5360	23021	23069	29	29
NC_010807.alt1	NC_002486.ref	56.8966	58	34843	34900	6414	6485	33	25
NC_010807.alt1	NC_002486.ref	48.0769	52	20679	20730	36571	36612	25	27
NC_010807.alt1	NC_002486.ref	54.9020	51	15368	15418	16868	16910	28	23
NC_010807.alt1	NC_002486.ref	40.8163	49	6629	6677	23999	24038	20	29
NC_010807.alt1	NC_002486.ref	69.3878	49	34622	34670	26193	26292	34	15
NC_010807.alt1	NC_002486.ref	62.5	48	13304	13351	13242	13325	30	18
NC_010807.alt1	NC_002486.ref	66.6667	48	15702	15749	34109	34073	32	16
NC_010807.alt1	NC_002486.ref	48.9362	47	29464	29510	42636	42599	23	24
NC_010807.alt1	NC_002486.ref	40.4255	47	32838	32884	33031	33070	19	28
NC_010807.alt1	NC_002486.ref	66.6667	45	21186	21230	21833	21910	30	15
NC_010807.alt1	NC_002486.ref	47.6190	42	8676	8717	7861	7894	20	22
NC_010807.alt1	NC_002486.ref	69.0476	42	28313	28354	32889	32943	29	13
NC_010807.alt1	NC_002486.ref	6e+01	40	24901	24940	9078	9115	24	16
NC_010807.alt1	NC_002486.ref	71.7949	39	23450	23488	10506	10553	28	11
NC_010807.alt2	NC_010807.alt3	98.6012	3503	9320	12822	8840	12342	3454	49
NC_010807.alt2	NC_010807.alt3	98.8494	2868	31133	34000	30074	32941	2835	33
NC_010807.alt2	NC_010807.alt3	98.9660	2031	20725	22755	20102	22132	2010	21
NC_010807.alt2	NC_010807.alt3	98.3297	1856	27404	29259	26510	28365	1825	31
NC_010807.alt2	NC_010807.alt3	98.6293	1605	1092	2696	1401	3005	1583	22
NC_010807.alt2	NC_010807.alt3	98.9247	1581	38975	40555	38311	39891	1564	17
NC_010807.alt2	NC_010807.alt3	98.4290	1464	22756	24219	22242	23705	1441	23
NC_010807.alt2	NC_010807.alt3	98.4149	1451	17871	19321	17364	18814	1428	23
NC_010807.alt2	NC_010807.alt3	98.8848	1345	34551	35895	33467	34811	1330	15
NC_010807.alt2	NC_010807.alt3	99.0423	1253	15916	17168	15380	16632	1241	12
NC_010807.alt2	NC_010807.alt3	98.32	1250	24619	25868	24209	25458	1229	21
NC_010807.alt2	NC_010807.alt3	98.0723	1245	3371	4615	3740	4984	1221	24
NC_010807.alt2	NC_010807.alt3	98.6026	1145	4821	5965	4980	6124	1129	16
NC_010807.alt2	NC_010807.alt3	98.2231	1013	12917	13929	12342	13354	995	18
NC_010807.alt2	NC_010807.alt3	97.7949	907	19322	20228	19025	19931	887	20
NC_010807.alt2	NC_010807.alt3	98.8277	853	15063	15915	14327	15179	843	10
NC_010807.alt2	NC_010807.alt3	98.875	800	8520	9319	7902	8701	791	9
NC_010807.alt2	NC_010807.alt3	98.6702	752	340	1091	447	1198	742	10
NC_010807.alt2	NC_010807.alt3	98.8636	704	30102	30805	28954	29657	696	8
NC_010807.alt2	NC_010807.alt3	98.8636	704	37149	37852	36380	37083	696	8
NC_010807.alt2	NC_010807.alt3	99.0028	702	17169	17870	16478	17179	695	7
NC_010807.alt2	NC_010807.alt3	98.0910	681	29421	30101	28365	29045	668	13
NC_010807.alt2	NC_010807.alt3	98.8176	592	7355	7946	7059	7650	585	7
NC_010807.alt2	NC_010807.alt3	99.1023	557	26145	26701	25458	26014	552	5
NC_010807.alt2	NC_010807.alt3	99.4526	548	14515	15062	13872	14419	545	3
NC_010807.alt2	NC_010807.alt3	99.2278	518	36629	37146	35648	36165	514	4
NC_010807.alt2	NC_010807.alt3	98.9899	495	26811	27305	26015	26509	490	5
NC_010807.alt2	NC_010807.alt3	98.9451	474	14041	14514	13355	13828	469	5
NC_010807.alt2	NC_010807.alt3	98.4581	454	35896	36349	34910	35363	447	7
NC_010807.alt2	NC_010807.alt3	99.0610	426	6243	6668	6127	6552	422	4
NC_010807.alt2	NC_010807.alt3	99.5098	408	34143	34550	33173	33580	406	2
NC_010807.alt2	NC_010807.alt3	99.7512	402	6953	7354	6551	6952	401	1
NC_010807.alt2	NC_010807.alt3	97.8320	369	38261	38629	37757	38125	361	8
NC_010807.alt2	NC_010807.alt3	1e+02	361	8159	8519	7651	8011	361	0
NC_010807.alt2	NC_010807.alt3	99.3884	327	30806	31132	29933	30259	325	2
NC_010807.alt2	NC_010807.alt3	1e+02	276	25869	26144	3616	3341	276	0
NC_010807.alt2	NC_010807.alt3	99.6364	275	38700	38974	29932	29658	274	1
NC_010807.alt2	NC_010807.alt3	99.1525	236	24220	24455	23617	23852	234	2
NC_010807.alt2	NC_010807.alt3	1e+02	236	38025	38260	37293	37528	236	0
NC_010807.alt2	NC_010807.alt3	98.6239	218	20229	20446	37539	37756	215	3
NC_010807.alt2	NC_010807.alt3	99.0566	212	7947	8158	36379	36168	210	2
NC_010807.alt2	NC_010807.alt3	99.0244	205	4616	4820	37287	37083	203	2
NC_010807.alt2	NC_010807.alt3	99.5	200	3171	3370	19014	18815	199	1
NC_010807.alt2	NC_010807.alt3	1e+02	183	1	183	39662	39844	183	0
NC_010807.alt2	NC_010807.alt3	99.4253	174	2697	2870	3168	3341	173	1
NC_010807.alt2	NC_010807.alt3	97.6879	173	36350	36522	35475	35647	169	4
NC_010807.alt2	NC_010807.alt3	1e+02	172	20447	20618	19922	20093	172	0
NC_010807.alt2	NC_010807.alt3	99.3865	163	24456	24618	23948	24110	162	1
NC_010807.alt2	NC_010807.alt3	97.5155	161	29260	29420	3005	3165	157	4
NC_010807.alt2	NC_010807.alt3	99.3590	156	184	339	39736	39891	155	1
NC_010807.alt2	NC_010807.alt3	1e+02	149	37853	38001	37294	37442	149	0
NC_010807.alt2	NC_010807.alt3	99.2754	138	6669	6806	8839	8702	137	1
NC_010807.alt2	NC_010807.alt3	97.7099	131	3040	3170	3619	3749	128	3
NC_010807.alt2	NC_010807.alt3	99.1870	123	6807	6929	6553	6675	122	1
NC_010807.alt2	NC_010807.alt3	1e+02	116	6125	6240	38240	38125	116	0
NC_010807.alt2	NC_010807.alt3	1e+02	115	5966	6080	38239	38125	115	0
NC_010807.alt2	NC_010807.alt3	98.1982	111	13930	14040	35363	35473	109	2
NC_010807.alt2	NC_010807.alt3	1e+02	109	26702	26810	22241	22133	109	0
NC_010807.alt2	NC_010807.alt3	94.3396	106	20619	20724	24111	24216	100	6
NC_010807.alt2	NC_010807.alt3	1e+02	103	36526	36628	6956	7058	103	0
NC_010807.alt2	NC_010807.alt3	98.9796	98	27306	27403	34812	34909	97	1
NC_010807.alt2	NC_010807.alt3	98.9362	94	12823	12916	23854	23947	93	1
NC_010807.alt2	NC_010807.alt3	1e+02	88	2871	2958	3619	3706	88	0
NC_010807.alt2	NC_010807.alt3	1e+02	81	2959	3039	3261	3341	81	0
NC_010807.alt2	NC_010807.alt3	1e+02	73	34001	34073	33173	33245	73	0
NC_010807.alt2	NC_010807.alt3	1e+02	70	38630	38699	38241	38310	70	0
NC_010807.alt2	NC_010807.alt3	1e+02	69	34074	34142	32873	32941	69	0
NC_010807.ref	NC_010807.alt2	98.8544	6896	16380	23275	17324	24219	6817	79
NC_010807.ref	NC_010807.alt2	98.8522	6447	7934	14380	8630	15107	6373	74
NC_010807.ref	NC_010807.alt2	98.7565	5790	23279	29068	24312	30101	5718	72
NC_010807.ref	NC_010807.alt2	99.1310	3337	33098	36434	34665	38001	3308	29
NC_010807.ref	NC_010807.alt2	98.6595	2984	2850	5833	3128	6111	2944	40
NC_010807.ref	NC_010807.alt2	99.1289	2755	30008	32762	31319	34073	2731	24
NC_010807.ref	NC_010807.alt2	99.0248	2666	184	2849	293	2958	2640	26
NC_010807.ref	NC_010807.alt2	99.0760	2381	36435	38815	38175	40555	2359	22
NC_010807.ref	NC_010807.alt2	99.3497	1999	14381	16379	15170	17168	1986	13
NC_010807.ref	NC_010807.alt2	99.4452	1442	6492	7933	7078	8519	1434	8
NC_010807.ref	NC_010807.alt2	99.0415	939	29069	30007	30194	31132	930	9
NC_010807.ref	NC_010807.alt2	99.2401	658	5834	6491	6272	6929	653	5
NC_010807.ref	NC_010807.alt2	99.4030	335	32763	33097	34216	34550	333	2
NC_010807.ref	NC_010807.alt2	1e+02	183	1	183	1	183	183	0
NC_010807.alt3	NC_010807.ref	99.7145	3503	8840	12342	8624	12126	3493	10
NC_010807.alt3	NC_010807.ref	99.7008	3008	29934	32941	29682	32689	2999	9
NC_010807.alt3	NC_010807.ref	99.9019	2039	20094	22132	19773	21811	2037	2
NC_010807.alt3	NC_010807.ref	99.7845	1856	26510	28365	26371	28226	1852	4
NC_010807.alt3	NC_010807.ref	99.7225	1802	15378	17179	15125	16926	1797	5
NC_010807.alt3	NC_010807.ref	99.6339	1639	33173	34811	32690	34328	1633	6
NC_010807.alt3	NC_010807.ref	99.8139	1612	1394	3005	976	2587	1609	3
NC_010807.alt3	NC_010807.ref	99.6257	1603	22250	23852	21820	23422	1597	6
NC_010807.alt3	NC_010807.ref	99.8102	1581	38311	39891	37235	38815	1578	3
NC_010807.alt3	NC_010807.ref	99.7935	1453	17362	18814	16925	18377	1450	3
NC_010807.alt3	NC_010807.ref	99.6947	1310	13870	15179	13817	15126	1306	4
NC_010807.alt3	NC_010807.ref	99.7678	1292	28366	29657	28389	29680	1289	3
NC_010807.alt3	NC_010807.ref	99.7585	1242	24217	25458	23594	24835	1239	3
NC_010807.alt3	NC_010807.ref	99.6761	1235	3750	4984	3103	4337	1231	4
NC_010807.alt3	NC_010807.ref	1e+02	1140	4985	6124	4548	5687	1140	0
NC_010807.alt3	NC_010807.ref	1e+02	1051	7651	8701	7573	8623	1051	0
NC_010807.alt3	NC_010807.ref	99.6047	1012	12343	13354	12222	13233	1008	4
NC_010807.alt3	NC_010807.ref	99.2282	907	19025	19931	18378	19284	900	7
NC_010807.alt3	NC_010807.ref	97.5093	803	423	1225	207	1024	783	20
NC_010807.alt3	NC_010807.ref	99.7159	704	36380	37083	35582	36285	702	2
NC_010807.alt3	NC_010807.ref	99.8311	592	7059	7650	6769	7360	591	1
NC_010807.alt3	NC_010807.ref	99.8201	556	25459	26014	25113	25668	555	1
NC_010807.alt3	NC_010807.ref	1e+02	520	35648	36167	35062	35581	520	0
NC_010807.alt3	NC_010807.ref	99.7980	495	26015	26509	25778	26272	494	1
NC_010807.alt3	NC_010807.ref	99.7890	474	13355	13828	13345	13818	473	1
NC_010807.alt3	NC_010807.ref	99.5595	454	34910	35363	34329	34782	452	2
NC_010807.alt3	NC_010807.ref	1e+02	426	6127	6552	5805	6230	426	0
NC_010807.alt3	NC_010807.ref	99.75	400	6553	6952	6369	6768	399	1
NC_010807.alt3	NC_010807.ref	99.7290	369	37757	38125	36521	36889	368	1
NC_010807.alt3	NC_010807.ref	99.6454	282	3342	3623	25110	24829	281	1
NC_010807.alt3	NC_010807.ref	1e+02	276	29658	29933	37234	36959	276	0
NC_010807.alt3	NC_010807.ref	1e+02	236	37293	37528	36285	36520	236	0
NC_010807.alt3	NC_010807.ref	1e+02	228	37529	37756	19275	19502	228	0
NC_010807.alt3	NC_010807.ref	96.2963	216	1	216	1	216	208	8
NC_010807.alt3	NC_010807.ref	1e+02	212	36168	36379	7572	7361	212	0
NC_010807.alt3	NC_010807.ref	1e+02	210	18815	19024	3092	2883	210	0
NC_010807.alt3	NC_010807.ref	1e+02	209	37084	37292	4541	4333	209	0
NC_010807.alt3	NC_010807.ref	1e+02	175	3167	3341	2587	2761	175	0
NC_010807.alt3	NC_010807.ref	1e+02	163	23948	24110	23423	23585	163	0
NC_010807.alt3	NC_010807.ref	1e+02	162	19932	20093	19513	19674	162	0
NC_010807.alt3	NC_010807.ref	1e+02	161	3006	3166	28228	28388	161	0
NC_010807.alt3	NC_010807.ref	99.3789	161	35487	35647	34795	34955	160	1
NC_010807.alt3	NC_010807.ref	1e+02	138	8702	8839	6368	6231	138	0
NC_010807.alt3	NC_010807.ref	96.8254	126	3624	3749	2767	2892	122	4
NC_010807.alt3	NC_010807.ref	94.3089	123	35364	35486	13235	13357	116	7
NC_010807.alt3	NC_010807.ref	98.2906	117	22133	22249	25777	25661	115	2
NC_010807.alt3	NC_010807.ref	1e+02	115	38126	38240	5801	5687	115	0
NC_010807.alt3	NC_010807.ref	1e+02	106	6953	7058	34956	35061	106	0
NC_010807.alt3	NC_010807.ref	95.2830	106	24111	24216	19675	19780	101	5
NC_010807.alt3	NC_010807.ref	1e+02	98	34812	34909	26273	26370	98	0
NC_010807.alt3	NC_010807.ref	1e+02	95	23853	23947	12126	12220	95	0
NC_010807.alt3	NC_010807.ref	1e+02	70	38241	38310	36890	36959	70	0
NC_010807.alt1	NC_025457.ref	61.7647	102	4318	4419	20785	20924	63	39
NC_010807.alt1	NC_025457.ref	47	100	34591	34690	6990	6873	47	53
NC_010807.alt1	NC_025457.ref	55.9524	84	23647	23730	29055	29154	47	37
NC_010807.alt1	NC_025457.ref	55.5556	72	32975	33046	37093	37011	40	32
NC_010807.alt1	NC_025457.ref	60.3448	58	8131	8188	18932	19020	35	23
NC_010807.alt1	NC_025457.ref	67.2414	58	10334	10391	17573	17683	39	19
NC_010807.alt1	NC_025457.ref	56.8966	58	12836	12893	26948	27023	33	25
NC_010807.alt1	NC_025457.ref	42.1053	57	10973	11029	21990	21941	24	33
NC_010807.alt1	NC_025457.ref	57.8947	57	29778	29834	34483	34530	33	24
NC_010807.alt1	NC_025457.ref	49.0909	55	15828	15882	27247	27288	27	28
NC_010807.alt1	NC_025457.ref	55.7692	52	9112	9163	4950	4883	29	23
NC_010807.alt1	NC_025457.ref	48.0769	52	10701	10752	3593	3635	25	27
NC_010807.alt1	NC_025457.ref	57.6923	52	30982	31033	2464	2411	30	22
NC_010807.alt1	NC_025457.ref	56.8627	51	7528	7578	4838	4879	29	22
NC_010807.alt1	NC_025457.ref	52.9412	51	31487	31537	25802	25855	27	24
NC_010807.alt1	NC_025457.ref	58.8235	51	37482	37532	11884	11937	30	21
NC_010807.alt1	NC_025457.ref	72.9167	48	20575	20622	12743	12798	35	13
NC_010807.alt1	NC_025457.ref	56.25	48	24660	24707	35479	35441	27	21
NC_010807.alt1	NC_025457.ref	60.4167	48	28027	28074	4066	4010	29	19
NC_010807.alt1	NC_025457.ref	63.0435	46	28158	28203	23967	24030	29	17
NC_010807.alt1	NC_025457.ref	55.5556	45	3992	4036	33858	33894	25	20
NC_010807.alt1	NC_025457.ref	53.3333	45	5374	5418	25297	25331	24	21
NC_010807.alt1	NC_025457.ref	66.6667	45	9182	9226	6710	6788	30	15
NC_010807.alt1	NC_025457.ref	55.5556	45	9373	9417	35806	35843	25	20
NC_010807.alt1	NC_025457.ref	68.8889	45	19865	19909	24112	24148	31	14
NC_010807.alt1	NC_025457.ref	64.4444	45	26117	26161	30934	30893	29	16
NC_010807.alt1	NC_025457.ref	67.5	40	4907	4946	10479	10529	27	13
NC_010807.alt1	NC_025457.ref	64.1026	39	18865	18903	34344	34406	25	14
NC_010807.alt1	NC_025457.ref	66.6667	39	25045	25083	41327	41387	26	13
NC_010807.alt1	NC_025457.ref	55.2632	38	1256	1293	23227	23262	21	17
NC_010807.alt1	NC_025457.ref	62.1622	37	19741	19777	40626	40662	23	14
NC_010807.alt1	NC_025457.ref	69.4444	36	6721	6756	9865	9826	25	11
NC_010807.alt1	NC_025457.ref	69.4444	36	8844	8879	23927	23956	25	11
NC_010807.alt1	NC_025457.ref	71.4286	35	18726	18760	12874	12918	25	10
NC_010807.alt1	NC_025457.ref	6e+01	35	24431	24465	32499	32533	21	14
NC_025457.alt1	NC_025457.alt2	91.4842	822	39687	40508	62673	63534	752	70
NC_025457.alt1	NC_025457.alt2	90.9639	664	18593	19256	30403	31080	604	60
NC_025457.alt1	NC_025457.alt2	90.3716	592	7453	8044	11206	11824	535	57
NC_025457.alt1	NC_025457.alt2	91	500	34637	35136	54198	54697	455	45
NC_025457.alt1	NC_025457.alt2	91.0448	469	26850	27318	41844	42299	427	42
NC_025457.alt1	NC_025457.alt2	92.4569	464	17170	17633	27979	28442	429	35
NC_025457.alt1	NC_025457.alt2	91.1905	420	25000	25419	39523	39981	383	37
NC_025457.alt1	NC_025457.alt2	88.5638	376	21596	21971	34823	35198	333	43
NC_025457.alt1	NC_025457.alt2	95.9459	370	15864	16233	25598	25967	355	15
NC_025457.alt1	NC_025457.alt2	89.1892	370	31352	31721	49080	49449	330	40
NC_025457.alt1	NC_025457.alt2	92.3913	368	6022	6389	9781	10148	340	28
NC_025457.alt1	NC_025457.alt2	89.5775	355	33251	33605	52550	52947	318	37
NC_025457.alt1	NC_025457.alt2	88.2857	350	33606	33955	53043	53392	309	41
NC_025457.alt1	NC_025457.alt2	87.3156	339	2467	2805	3848	4195	296	43
NC_025457.alt1	NC_025457.alt2	87.1257	334	16333	16666	26352	26685	291	43
NC_025457.alt1	NC_025457.alt2	95.1952	333	29092	29424	45761	46093	317	16
NC_025457.alt1	NC_025457.alt2	89.1641	323	4971	5293	7648	7970	288	35
NC_025457.alt1	NC_025457.alt2	90.0312	321	19809	20129	31904	32224	289	32
NC_025457.alt1	NC_025457.alt2	86.9863	292	3555	3846	5332	5638	254	38
NC_025457.alt1	NC_025457.alt2	98.2394	284	14312	14595	22703	22986	279	5
NC_025457.alt1	NC_025457.alt2	98.5663	279	12245	12523	20209	20487	275	4
NC_025457.alt1	NC_025457.alt2	86.2816	277	20300	20576	32824	33100	239	38
NC_025457.alt1	NC_025457.alt2	93.8697	261	16903	17163	27575	27835	245	16
NC_025457.alt1	NC_025457.alt2	88.1226	261	18178	18438	29630	29904	230	31
NC_025457.alt1	NC_025457.alt2	89.4118	255	12828	13082	21052	21326	228	27
NC_025457.alt1	NC_025457.alt2	90.0398	251	13489	13739	21656	21939	226	25
NC_025457.alt1	NC_025457.alt2	86.0558	251	21055	21305	34273	34523	216	35
NC_025457.alt1	NC_025457.alt2	89.5161	248	141	388	291	538	222	26
NC_025457.alt1	NC_025457.alt2	95.5645	248	35351	35598	55115	55362	237	11
NC_025457.alt1	NC_025457.alt2	99.5951	247	31722	31968	12284	12038	246	1
NC_025457.alt1	NC_025457.alt2	91.0204	245	23009	23253	36340	36584	223	22
NC_025457.alt1	NC_025457.alt2	96.1702	235	16668	16902	27191	27425	226	9
NC_025457.alt1	NC_025457.alt2	89.3617	235	38751	38985	61367	61634	210	25
NC_025457.alt1	NC_025457.alt2	89.8678	227	8144	8370	11814	12040	204	23
NC_025457.alt1	NC_025457.alt2	87.1681	226	11170	11395	18580	18805	197	29
NC_025457.alt1	NC_025457.alt2	89.7321	224	24324	24547	38849	39072	201	23
NC_025457.alt1	NC_025457.alt2	85.1351	222	34415	34636	53880	54103	189	33
NC_025457.alt1	NC_025457.alt2	96.3636	220	27434	27653	42623	42842	212	8
NC_025457.alt1	NC_025457.alt2	93.4884	215	22277	22491	35400	35614	201	14
NC_025457.alt1	NC_025457.alt2	91.1215	214	6654	6867	10448	10661	195	19
NC_025457.alt1	NC_025457.alt2	95.6938	209	1363	1571	2081	2316	200	9
NC_025457.alt1	NC_025457.alt2	89.8058	206	36368	36573	56800	57005	185	21
NC_025457.alt1	NC_025457.alt2	95.5882	204	11797	12000	19612	19815	195	9
NC_025457.alt1	NC_025457.alt2	87.1287	202	28888	29089	45295	45496	176	26
NC_025457.alt1	NC_025457.alt2	87.3737	198	785	982	1431	1628	173	25
NC_025457.alt1	NC_025457.alt2	98.4772	197	3847	4043	5915	6111	194	3
NC_025457.alt1	NC_025457.alt2	84.6939	196	32684	32879	50723	50928	166	30
NC_025457.alt1	NC_025457.alt2	88.9474	190	13088	13277	21163	21372	169	21
NC_025457.alt1	NC_025457.alt2	98.9189	185	29649	29833	8315	8499	183	2
NC_025457.alt1	NC_025457.alt2	89.7297	185	30612	30796	48014	48198	166	19
NC_025457.alt1	NC_025457.alt2	98.9071	183	35698	35880	55552	55734	181	2
NC_025457.alt1	NC_025457.alt2	87.9121	182	23663	23844	38046	38227	160	22
NC_025457.alt1	NC_025457.alt2	89.5604	182	36060	36241	56513	56694	163	19
NC_025457.alt1	NC_025457.alt2	88.5057	174	10286	10459	16550	16723	154	20
NC_025457.alt1	NC_025457.alt2	97.1264	174	37693	37866	58900	59088	169	5
NC_025457.alt1	NC_025457.alt2	87.2832	173	14136	14308	22485	22668	151	22
NC_025457.alt1	NC_025457.alt2	94.7674	172	22104	22275	35361	35532	163	9
NC_025457.alt1	NC_025457.alt2	94.7674	172	34195	34366	53701	53889	163	9
NC_025457.alt1	NC_025457.alt2	98.2456	171	35137	35307	54845	55015	168	3
NC_025457.alt1	NC_025457.alt2	85.2941	170	15240	15409	24586	24755	145	25
NC_025457.alt1	NC_025457.alt2	85.8824	170	24146	24315	38614	38783	146	24
NC_025457.alt1	NC_025457.alt2	1e+02	169	37332	37500	47627	47795	169	0
NC_025457.alt1	NC_025457.alt2	90.4192	167	13817	13983	22123	22313	151	16
NC_025457.alt1	NC_025457.alt2	84.3373	166	4447	4612	7488	7653	140	26
NC_025457.alt1	NC_025457.alt2	87.8788	165	21306	21470	34360	34524	145	20
NC_025457.alt1	NC_025457.alt2	92.1212	165	25583	25747	40243	40407	152	13
NC_025457.alt1	NC_025457.alt2	91.3580	162	389	550	581	742	148	14
NC_025457.alt1	NC_025457.alt2	86.4198	162	10460	10621	16845	17006	140	22
NC_025457.alt1	NC_025457.alt2	91.7722	158	20139	20296	32427	32584	145	13
NC_025457.alt1	NC_025457.alt2	87.0968	155	17845	17999	29168	29322	135	20
NC_025457.alt1	NC_025457.alt2	90.9091	154	1619	1772	2318	2471	140	14
NC_025457.alt1	NC_025457.alt2	98.7013	154	2807	2960	63631	63784	152	2
NC_025457.alt1	NC_025457.alt2	90.2597	154	9692	9845	15132	15285	139	15
NC_025457.alt1	NC_025457.alt2	96.0784	153	1109	1261	1930	2082	147	6
NC_025457.alt1	NC_025457.alt2	93.4641	153	30931	31083	48470	48622	143	10
NC_025457.alt1	NC_025457.alt2	97.3684	152	20666	20817	33405	33556	148	4
NC_025457.alt1	NC_025457.alt2	97.3510	151	14680	14830	23129	23279	147	4
NC_025457.alt1	NC_025457.alt2	91.3333	150	25984	26133	40768	40917	137	13
NC_025457.alt1	NC_025457.alt2	90.6667	150	38320	38469	60312	60461	136	14
NC_025457.alt1	NC_025457.alt2	88.5906	149	28007	28155	44112	44294	132	17
NC_025457.alt1	NC_025457.alt2	91.8919	148	30325	30472	47293	47478	136	12
NC_025457.alt1	NC_025457.alt2	97.2973	148	38470	38617	60515	60662	144	4
NC_025457.alt1	NC_025457.alt2	87.6712	146	31203	31348	48622	48787	128	18
NC_025457.alt1	NC_025457.alt2	90.4110	146	38172	38317	60095	60240	132	14
NC_025457.alt1	NC_025457.alt2	89.4366	142	5402	5543	8505	8646	127	15
NC_025457.alt1	NC_025457.alt2	91.4894	141	1774	1914	2592	2732	129	12
NC_025457.alt1	NC_025457.alt2	89.2857	140	1	140	1	140	125	15
NC_025457.alt1	NC_025457.alt2	89.2086	139	24005	24143	38380	38518	124	15
NC_025457.alt1	NC_025457.alt2	84.5588	136	14967	15102	24452	24587	115	21
NC_025457.alt1	NC_025457.alt2	88.8889	135	2079	2213	2860	2994	120	15
NC_025457.alt1	NC_025457.alt2	85.9259	135	24553	24687	39266	39400	116	19
NC_025457.alt1	NC_025457.alt2	87.3134	134	22548	22681	36002	35869	117	17
NC_025457.alt1	NC_025457.alt2	97.0149	134	26383	26516	41145	41278	130	4
NC_025457.alt1	NC_025457.alt2	90.2256	133	30798	30930	48417	48549	120	13
NC_025457.alt1	NC_025457.alt2	87.7863	131	2336	2466	3461	3591	115	16
NC_025457.alt1	NC_025457.alt2	85.3846	130	4613	4742	7530	7659	111	19
NC_025457.alt1	NC_025457.alt2	90.6977	129	37874	38002	59217	59345	117	12
NC_025457.alt1	NC_025457.alt2	91.4063	128	24810	24937	39523	39689	117	11
NC_025457.alt1	NC_025457.alt2	87.4016	127	655	781	1100	1226	111	16
NC_025457.alt1	NC_025457.alt2	86.4	125	27882	28006	43858	44000	108	17
NC_025457.alt1	NC_025457.alt2	88.7097	124	5641	5764	9121	9244	110	14
NC_025457.alt1	NC_025457.alt2	87.8049	123	9566	9688	14908	15030	108	15
NC_025457.alt1	NC_025457.alt2	99.1870	123	26725	26847	41278	41400	122	1
NC_025457.alt1	NC_025457.alt2	86.6667	120	2214	2333	3137	3256	104	16
NC_025457.alt1	NC_025457.alt2	1e+02	119	24688	24806	39518	39400	119	0
NC_025457.alt1	NC_025457.alt2	1e+02	119	31084	31202	17903	18021	119	0
NC_025457.alt1	NC_025457.alt2	1e+02	119	32965	33083	51836	51954	119	0
NC_025457.alt1	NC_025457.alt2	87.2881	118	17727	17844	28815	28932	103	15
NC_025457.alt1	NC_025457.alt2	87.1795	117	9071	9187	14644	14760	102	15
NC_025457.alt1	NC_025457.alt2	91.4530	117	25849	25965	40768	40884	107	10
NC_025457.alt1	NC_025457.alt2	98.2759	116	21972	22087	23900	23785	114	2
NC_025457.alt1	NC_025457.alt2	99.1379	116	27766	27881	43657	43772	115	1
NC_025457.alt1	NC_025457.alt2	90.2655	113	20872	20984	34161	34273	102	11
NC_025457.alt1	NC_025457.alt2	88.3929	112	30477	30588	47504	47615	99	13
NC_025457.alt1	NC_025457.alt2	91.9643	112	38055	38166	59836	59947	103	9
NC_025457.alt1	NC_025457.alt2	99.0991	111	12132	12242	20004	20114	110	1
NC_025457.alt1	NC_025457.alt2	88.0734	109	27323	27431	42384	42492	96	13
NC_025457.alt1	NC_025457.alt2	89.7196	107	4340	4446	7484	7378	96	11
NC_025457.alt1	NC_025457.alt2	94.3925	107	8371	8477	12287	12393	101	6
NC_025457.alt1	NC_025457.alt2	86.7925	106	23481	23586	37013	37118	92	14
NC_025457.alt1	NC_025457.alt2	88.5714	105	5294	5398	8200	8313	93	12
NC_025457.alt1	NC_025457.alt2	92.3810	105	6549	6653	10429	10533	97	8
NC_025457.alt1	NC_025457.alt2	88.5714	105	9980	10084	15797	15901	93	12
NC_025457.alt1	NC_025457.alt2	98.0952	105	38618	38722	61363	61259	103	2
NC_025457.alt1	NC_025457.alt2	92.3077	104	37589	37692	58897	58794	96	8
NC_025457.alt1	NC_025457.alt2	91.2621	103	12724	12826	20894	20996	94	9
NC_025457.alt1	NC_025457.alt2	93.1373	102	8506	8607	13101	13202	95	7
NC_025457.alt1	NC_025457.alt2	92.1569	102	32071	32172	33401	33265	94	8
NC_025457.alt1	NC_025457.alt2	92.1569	102	32226	32327	33401	33265	94	8
NC_025457.alt1	NC_025457.alt2	89.1089	101	6390	6490	10324	10424	90	11
NC_025457.alt1	NC_025457.alt2	92.0792	101	10624	10724	17387	17510	93	8
NC_025457.alt1	NC_025457.alt2	1e+02	101	21473	21573	34627	34527	101	0
NC_025457.alt1	NC_025457.alt2	9e+01	100	28422	28521	45023	45122	90	10
NC_025457.alt1	NC_025457.alt2	67	100	40829	40928	63882	63988	67	33
NC_025457.alt1	NC_025457.alt2	77.7778	99	16234	16332	26147	26254	77	22
NC_025457.alt1	NC_025457.alt2	88.7755	98	551	648	905	1002	87	11
NC_025457.alt1	NC_025457.alt2	88.6598	97	10866	10962	18330	18426	86	11
NC_025457.alt1	NC_025457.alt2	89.6907	97	31972	32068	49454	49550	87	10
NC_025457.alt1	NC_025457.alt2	91.6667	96	1262	1357	2180	2302	88	8
NC_025457.alt1	NC_025457.alt2	91.6667	96	5544	5639	8882	8977	88	8
NC_025457.alt1	NC_025457.alt2	88.5417	96	35964	36059	56264	56359	85	11
NC_025457.alt1	NC_025457.alt2	98.9362	94	18000	18093	54197	54104	93	1
NC_025457.alt1	NC_025457.alt2	89.3617	94	36656	36749	57840	57933	84	10
NC_025457.alt1	NC_025457.alt2	88.2979	94	40929	41022	63920	64013	83	11
NC_025457.alt1	NC_025457.alt2	94.6237	93	17634	17726	28614	28706	88	5
NC_025457.alt1	NC_025457.alt2	92.4731	93	36753	36845	58123	58215	86	7
NC_025457.alt1	NC_025457.alt2	90.2174	92	8611	8702	13336	13427	83	9
NC_025457.alt1	NC_025457.alt2	1e+02	91	37241	37331	47617	47707	91	0
NC_025457.alt1	NC_025457.alt2	92.2222	90	4174	4263	6699	6788	83	7
NC_025457.alt1	NC_025457.alt2	88.7640	89	1019	1107	1631	1719	79	10
NC_025457.alt1	NC_025457.alt2	91.9540	87	6895	6981	10905	10991	80	7
NC_025457.alt1	NC_025457.alt2	85.0575	87	23845	23931	38261	38347	74	13
NC_025457.alt1	NC_025457.alt2	87.3563	87	27654	27740	43000	43086	76	11
NC_025457.alt1	NC_025457.alt2	91.9540	87	36846	36932	58336	58422	80	7
NC_025457.alt1	NC_025457.alt2	98.8506	87	37501	37587	58767	58681	86	1
NC_025457.alt1	NC_025457.alt2	86.2069	87	40532	40618	63630	63544	75	12
NC_025457.alt1	NC_025457.alt2	87.2093	86	10780	10865	18022	18107	75	11
NC_025457.alt1	NC_025457.alt2	1e+02	86	11594	11679	45663	45748	86	0
NC_025457.alt1	NC_025457.alt2	88.3721	86	20577	20662	33233	33318	76	10
NC_025457.alt1	NC_025457.alt2	83.7209	86	40624	40709	63807	63892	72	14
NC_025457.alt1	NC_025457.alt2	89.2857	84	14596	14679	14126	14043	75	9
NC_025457.alt1	NC_025457.alt2	1e+02	84	23311	23394	36752	36669	84	0
NC_025457.alt1	NC_025457.alt2	90.3614	83	25755	25837	40474	40373	75	8
NC_025457.alt1	NC_025457.alt2	89.1566	83	39106	39188	62417	62499	74	9
NC_025457.alt1	NC_025457.alt2	86.5854	82	18096	18177	29325	29406	71	11
NC_025457.alt1	NC_025457.alt2	91.3580	81	36575	36655	57700	57780	74	7
NC_025457.alt1	NC_025457.alt2	93.75	80	7049	7128	10990	11069	75	5
NC_025457.alt1	NC_025457.alt2	86.25	80	13990	14069	22405	22484	69	11
NC_025457.alt1	NC_025457.alt2	89.8734	79	23398	23476	36758	36836	71	8
NC_025457.alt1	NC_025457.alt2	1e+02	79	32368	32446	49933	49855	79	0
NC_025457.alt1	NC_025457.alt2	88.1579	76	18442	18517	30039	30114	67	9
NC_025457.alt1	NC_025457.alt2	91.7808	73	4267	4339	7308	7380	67	6
NC_025457.alt1	NC_025457.alt2	89.0411	73	11680	11752	19063	19135	65	8
NC_025457.alt1	NC_025457.alt2	80.8219	73	19257	19329	31393	31465	59	14
NC_025457.alt1	NC_025457.alt2	90.2778	72	30006	30077	47082	47153	65	7
NC_025457.alt1	NC_025457.alt2	88.7324	71	34124	34194	53395	53465	63	8
NC_025457.alt1	NC_025457.alt2	94.3662	71	36242	36312	56800	56870	67	4
NC_025457.alt1	NC_025457.alt2	89.7059	68	9907	9974	15633	15700	61	7
NC_025457.alt1	NC_025457.alt2	89.5522	67	11478	11544	18996	19062	60	7
NC_025457.alt1	NC_025457.alt2	95.4545	66	39474	39539	62608	62673	63	3
NC_025457.alt1	NC_025457.alt2	93.8462	65	3372	3436	4801	4865	61	4
NC_025457.alt1	NC_025457.alt2	87.6923	65	32882	32946	51327	51391	57	8
NC_025457.alt1	NC_025457.alt2	85.7143	63	15801	15863	25219	25157	54	9
NC_025457.alt1	NC_025457.alt2	88.5246	61	29425	29485	46343	46403	54	7
NC_025457.alt1	NC_025457.alt2	88.1356	59	23587	23645	37623	37681	52	7
NC_025457.alt1	NC_025457.alt2	1e+02	59	24938	24996	39458	39400	59	0
NC_025457.alt1	NC_025457.alt2	87.9310	58	9849	9906	15459	15516	51	7
NC_025457.alt1	NC_025457.alt2	96.4912	57	2961	3017	4197	4253	55	2
NC_025457.alt1	NC_025457.alt2	89.4737	57	22706	22762	36125	36213	51	6
NC_025457.alt1	NC_025457.alt2	96.4912	57	28309	28365	44381	44437	55	2
NC_025457.alt1	NC_025457.alt2	94.7368	57	35883	35939	55893	55949	54	3
NC_025457.alt1	NC_025457.alt2	91.0714	56	14831	14886	23988	24043	51	5
NC_025457.alt1	NC_025457.alt2	87.5	56	23255	23310	36615	36670	49	7
NC_025457.alt1	NC_025457.alt2	46.4286	56	28191	28246	16177	16222	26	30
NC_025457.alt1	NC_025457.alt2	83.6364	55	10725	10779	17847	17901	46	9
NC_025457.alt1	NC_025457.alt2	87.2727	55	22492	22546	35814	35868	48	7
NC_025457.alt1	NC_025457.alt2	1e+02	55	33137	33191	52202	52148	55	0
NC_025457.alt1	NC_025457.alt2	94.5455	55	33194	33248	52388	52442	52	3
NC_025457.alt1	NC_025457.alt2	85.1852	54	20818	20871	33836	33889	46	8
NC_025457.alt1	NC_025457.alt2	61.1111	54	35644	35697	55903	55950	33	21
NC_025457.alt1	NC_025457.alt2	90.5660	53	10230	10282	16301	16353	48	5
NC_025457.alt1	NC_025457.alt2	96.2264	53	18535	18587	30208	30260	51	2
NC_025457.alt1	NC_025457.alt2	96.2264	53	33084	33136	52065	52117	51	2
NC_025457.alt1	NC_025457.alt2	92.3077	52	28257	28308	44287	44338	48	4
NC_025457.alt1	NC_025457.alt2	90.3846	52	38003	38054	59494	59545	47	5
NC_025457.alt1	NC_025457.alt2	88.2353	51	29834	29884	46651	46701	45	6
NC_025457.alt1	NC_025457.alt2	98.0392	51	32447	32497	50047	50097	50	1
NC_025457.alt1	NC_025457.alt2	89.7959	49	8703	8751	13484	13532	44	5
NC_025457.alt1	NC_025457.alt2	95.9184	49	8754	8802	13672	13746	47	2
NC_025457.alt1	NC_025457.alt2	1e+02	49	11545	11593	45487	45535	49	0
NC_025457.alt1	NC_025457.alt2	83.6735	49	15752	15800	25377	25329	41	8
NC_025457.alt1	NC_025457.alt2	89.7959	49	29885	29933	46831	46879	44	5
NC_025457.alt1	NC_025457.alt2	89.7959	49	32506	32554	50478	50526	44	5
NC_025457.alt1	NC_025457.alt2	93.8776	49	36319	36367	56646	56694	46	3
NC_025457.alt1	NC_025457.alt2	91.6667	48	1915	1962	2796	2847	44	4
NC_025457.alt1	NC_025457.alt2	91.6667	48	13441	13488	21504	21551	44	4
NC_025457.alt1	NC_025457.alt2	52.0833	48	37179	37226	46068	46014	25	23
NC_025457.alt1	NC_025457.alt2	89.3617	47	28372	28418	44805	44851	42	5
NC_025457.alt1	NC_025457.alt2	90.9091	44	25422	25465	40199	40242	40	4
NC_025457.alt1	NC_025457.alt2	88.6364	44	39059	39102	62217	62260	39	5
NC_025457.alt1	NC_025457.alt2	95.4545	44	41023	41066	64121	64164	42	2
NC_025457.alt1	NC_025457.alt2	86.0465	43	3035	3077	4574	4616	37	6
NC_025457.alt1	NC_025457.alt2	83.7209	43	10148	10190	15859	15901	36	7
NC_025457.alt1	NC_025457.alt2	90.6977	43	35308	35350	55168	55210	39	4
NC_025457.alt1	NC_025457.alt2	90.4762	42	8860	8901	13746	13787	38	4
NC_025457.alt1	NC_025457.alt2	60.9756	41	5873	5913	31669	31733	25	16
NC_025457.alt1	NC_025457.alt2	90.2439	41	26335	26375	40926	40966	37	4
NC_025457.alt1	NC_025457.alt2	87.8049	41	29937	29977	47042	47082	36	5
NC_025457.alt1	NC_025457.alt2	72.5	40	9031	9070	35617	35565	29	11
NC_025457.alt1	NC_025457.alt2	9e+01	40	28741	28780	45261	45300	36	4
NC_025457.alt1	NC_025457.alt2	82.0513	39	14887	14925	24142	24180	32	7
NC_025457.alt1	NC_025457.alt2	94.7368	38	32175	32212	49756	49793	36	2
NC_025457.alt1	NC_025457.alt2	94.7368	38	32330	32367	49756	49793	36	2
NC_025457.alt1	NC_025457.alt2	97.2973	37	22763	22799	36303	36339	36	1
NC_025457.alt1	NC_025457.alt2	94.5946	37	39189	39225	62572	62608	35	2
NC_025457.alt1	NC_025457.alt2	1e+02	36	11753	11788	19336	19371	36	0
NC_025457.alt1	NC_025457.alt2	91.6667	36	13781	13816	21896	21931	33	3
NC_025457.alt1	NC_025457.alt2	91.6667	36	15713	15748	25585	25550	33	3
NC_025457.alt1	NC_025457.alt2	94.4444	36	29486	29521	46594	46629	34	2
NC_025457.alt1	NC_025457.alt2	91.4286	35	8982	9016	14238	14272	32	3
NC_025457.alt1	NC_025457.alt2	97.1429	35	10087	10121	16146	16180	34	1
NC_025457.alt1	NC_025457.alt2	97.1429	35	10193	10227	16146	16180	34	1
NC_010807.alt3	NC_005091.alt1	53.9474	76	16875	16950	20995	21083	41	35
NC_010807.alt3	NC_005091.alt1	56.0606	66	5419	5484	47072	46992	37	29
NC_010807.alt3	NC_005091.alt1	58.0645	62	21276	21337	48646	48573	36	26
NC_010807.alt3	NC_005091.alt1	44.2623	61	28196	28256	30289	30333	27	34
NC_010807.alt3	NC_005091.alt1	53.3333	60	11651	11710	48876	48816	32	28
NC_010807.alt3	NC_005091.alt1	50.8772	57	30207	30263	33626	33585	29	28
NC_010807.alt3	NC_005091.alt1	48.2143	56	2923	2978	56071	56115	27	29
NC_010807.alt3	NC_005091.alt1	46.4286	56	23809	23864	24427	24520	26	30
NC_010807.alt3	NC_005091.alt1	41.8182	55	20036	20090	42914	42871	23	32
NC_010807.alt3	NC_005091.alt1	46.2963	54	18703	18756	45995	45952	25	29
NC_010807.alt3	NC_005091.alt1	66.6667	54	30759	30812	38458	38518	36	18
NC_010807.alt3	NC_005091.alt1	5e+01	54	31498	31551	54027	53985	27	27
NC_010807.alt3	NC_005091.alt1	66.0377	53	28519	28571	17715	17792	35	18
NC_010807.alt3	NC_005091.alt1	47.1698	53	39395	39447	6608	6667	25	28
NC_010807.alt3	NC_005091.alt1	60.7843	51	19544	19594	39815	39776	31	20
NC_010807.alt3	NC_005091.alt1	66.6667	51	24437	24487	15290	15331	34	17
NC_010807.alt3	NC_005091.alt1	56	50	3337	3386	54877	54831	28	22
NC_010807.alt3	NC_005091.alt1	6e+01	50	15907	15956	43569	43492	30	20
NC_010807.alt3	NC_005091.alt1	63.2653	49	10244	10292	4343	4300	31	18
NC_010807.alt3	NC_005091.alt1	55.1020	49	14656	14704	32778	32821	27	22
NC_010807.alt3	NC_005091.alt1	55.3191	47	17547	17593	37027	36993	26	21
NC_010807.alt3	NC_005091.alt1	59.5745	47	17612	17658	9546	9461	28	19
NC_010807.alt3	NC_005091.alt1	6e+01	45	12384	12428	54804	54875	27	18
NC_010807.alt3	NC_005091.alt1	65.9091	44	28643	28686	47882	47963	29	15
NC_010807.alt3	NC_005091.alt1	60.9756	41	22179	22219	24650	24583	25	16
NC_010807.alt3	NC_005091.alt1	75	40	1379	1418	53164	53229	30	10
NC_010807.alt3	NC_005091.alt1	7e+01	40	14526	14565	8084	8159	28	12
NC_010807.alt3	NC_005091.alt1	51.2821	39	16381	16419	44198	44169	20	19
NC_010807.alt3	NC_005091.alt1	69.2308	39	21453	21491	35656	35612	27	12
NC_010807.alt3	NC_005091.alt1	60.5263	38	21901	21938	29700	29667	23	15
NC_010807.alt3	NC_005091.alt1	67.5676	37	10930	10966	17216	17181	25	12
NC_010807.alt3	NC_005091.alt1	63.8889	36	7415	7450	17975	17919	23	13
NC_010807.alt3	NC_005091.alt1	75	36	11442	11477	35111	35064	27	9
NC_010807.alt3	NC_005091.alt1	66.6667	36	37678	37713	50573	50546	24	12
NC_010807.alt3	NC_005091.alt1	62.8571	35	18496	18530	54412	54378	22	13
NC_010807.alt3	NC_005091.alt1	71.4286	35	24713	24747	26823	26863	25	10
NC_010807.alt1	NC_010807.alt3	99.5920	2696	29681	32376	29933	32628	2685	11
NC_010807.alt1	NC_010807.alt3	99.0596	2233	7998	10230	8840	11072	2212	21
NC_010807.alt1	NC_010807.alt3	99.6061	2031	19781	21811	20102	22132	2023	8
NC_010807.alt1	NC_010807.alt3	99.6228	1856	26371	28226	26510	28365	1849	7
NC_010807.alt1	NC_010807.alt3	99.3899	1639	32690	34328	33173	34811	1629	10
NC_010807.alt1	NC_010807.alt3	99.4413	1611	21812	23422	22242	23852	1602	9
NC_010807.alt1	NC_010807.alt3	99.5572	1581	37235	38815	38311	39891	1574	7
NC_010807.alt1	NC_010807.alt3	99.4888	1565	577	2141	1441	3005	1557	8
NC_010807.alt1	NC_010807.alt3	99.5356	1292	28389	29680	28366	29657	1286	6
NC_010807.alt1	NC_010807.alt3	99.5763	1180	23586	24765	24209	25388	1175	5
NC_010807.alt1	NC_010807.alt3	99.5633	1145	3917	5061	4980	6124	1140	5
NC_010807.alt1	NC_010807.alt3	99.5614	1140	10231	11370	11189	12328	1135	5
NC_010807.alt1	NC_010807.alt3	99.4704	1133	15678	16810	16047	17179	1127	6
NC_010807.alt1	NC_010807.alt3	99.6307	1083	2629	3711	3902	4984	1079	4
NC_010807.alt1	NC_010807.alt3	99.5243	1051	6947	7997	7651	8701	1046	5
NC_010807.alt1	NC_010807.alt3	99.4269	1047	13257	14303	13872	14918	1041	6
NC_010807.alt1	NC_010807.alt3	99.5064	1013	11659	12671	12342	13354	1008	5
NC_010807.alt1	NC_010807.alt3	99.5851	964	16811	17774	17364	18327	960	4
NC_010807.alt1	NC_010807.alt3	99.1160	905	18262	19166	19025	19929	897	8
NC_010807.alt1	NC_010807.alt3	99.2898	704	35582	36285	36380	37083	699	5
NC_010807.alt1	NC_010807.alt3	99.7001	667	14849	15515	15380	16046	665	2
NC_010807.alt1	NC_010807.alt3	98.9865	592	6143	6734	7059	7650	586	6
NC_010807.alt1	NC_010807.alt3	99.2819	557	25112	25668	25458	26014	553	4
NC_010807.alt1	NC_010807.alt3	1e+02	520	35062	35581	35648	36167	520	0
NC_010807.alt1	NC_010807.alt3	99.7980	495	25778	26272	26015	26509	494	1
NC_010807.alt1	NC_010807.alt3	1e+02	468	109	576	609	1076	468	0
NC_010807.alt1	NC_010807.alt3	99.5662	461	12796	13256	13368	13828	459	2
NC_010807.alt1	NC_010807.alt3	98.8987	454	34329	34782	34910	35363	449	5
NC_010807.alt1	NC_010807.alt3	99.75	400	5743	6142	6553	6952	399	1
NC_010807.alt1	NC_010807.alt3	99.4845	388	17874	18261	18427	18814	386	2
NC_010807.alt1	NC_010807.alt3	99.1870	369	36521	36889	37757	38125	366	3
NC_010807.alt1	NC_010807.alt3	1e+02	282	5323	5604	6271	6552	282	0
NC_010807.alt1	NC_010807.alt3	1e+02	275	36960	37234	29932	29658	275	0
NC_010807.alt1	NC_010807.alt3	99.6154	260	14589	14848	14920	15179	259	1
NC_010807.alt1	NC_010807.alt3	1e+02	235	36286	36520	37294	37528	235	0
NC_010807.alt1	NC_010807.alt3	1e+02	229	24883	25111	3569	3341	229	0
NC_010807.alt1	NC_010807.alt3	99.0610	213	32477	32689	32729	32941	211	2
NC_010807.alt1	NC_010807.alt3	99.5122	205	3712	3916	37287	37083	204	1
NC_010807.alt1	NC_010807.alt3	98.9247	186	14304	14489	608	423	184	2
NC_010807.alt1	NC_010807.alt3	1e+02	182	2447	2628	19014	18833	182	0
NC_010807.alt1	NC_010807.alt3	1e+02	174	2142	2315	3168	3341	174	0
NC_010807.alt1	NC_010807.alt3	99.4220	173	34783	34955	35475	35647	172	1
NC_010807.alt1	NC_010807.alt3	1e+02	172	19503	19674	19922	20093	172	0
NC_010807.alt1	NC_010807.alt3	1e+02	163	19340	19502	37594	37756	163	0
NC_010807.alt1	NC_010807.alt3	1e+02	163	23423	23585	23948	24110	163	0
NC_010807.alt1	NC_010807.alt3	1e+02	162	11389	11550	3740	3901	162	0
NC_010807.alt1	NC_010807.alt3	99.3827	162	28227	28388	3005	3166	161	1
NC_010807.alt1	NC_010807.alt3	1e+02	138	5605	5742	8839	8702	138	0
NC_010807.alt1	NC_010807.alt3	96.9466	131	2316	2446	3619	3749	127	4
NC_010807.alt1	NC_010807.alt3	94.3548	124	12672	12795	35363	35486	117	7
NC_010807.alt1	NC_010807.alt3	96.7213	122	15516	15637	1077	1198	118	4
NC_010807.alt1	NC_010807.alt3	1e+02	121	5202	5322	6270	6150	121	0
NC_010807.alt1	NC_010807.alt3	1e+02	115	5062	5176	38239	38125	115	0
NC_010807.alt1	NC_010807.alt3	1e+02	115	19225	19339	11183	11069	115	0
NC_010807.alt1	NC_010807.alt3	1e+02	109	25669	25777	22241	22133	109	0
NC_010807.alt1	NC_010807.alt3	99.0654	107	1	107	1	107	106	1
NC_010807.alt1	NC_010807.alt3	94.3396	106	11553	11658	23842	23947	100	6
NC_010807.alt1	NC_010807.alt3	94.3396	106	19675	19780	24111	24216	100	6
NC_010807.alt1	NC_010807.alt3	1e+02	106	34956	35061	6953	7058	106	0
NC_010807.alt1	NC_010807.alt3	1e+02	102	6793	6894	36220	36321	102	0
NC_010807.alt1	NC_010807.alt3	1e+02	100	32377	32476	32727	32628	100	0
NC_010807.alt1	NC_010807.alt3	1e+02	99	14490	14588	206	108	99	0
NC_010807.alt1	NC_010807.alt3	1e+02	99	17775	17873	18425	18327	99	0
NC_010807.alt1	NC_010807.alt3	1e+02	98	26273	26370	34812	34909	98	0
NC_010807.alt1	NC_010807.alt3	97.2222	72	24811	24882	25451	25380	70	2
NC_010807.alt1	NC_010807.alt3	1e+02	70	36890	36959	38241	38310	70	0
NC_010807.alt1	NC_010807.alt3	98.2759	58	6735	6792	36379	36322	57	1
NC_010807.alt1	NC_010807.alt3	1e+02	55	19170	19224	37540	37594	55	0
NC_010807.alt1	NC_010807.alt3	1e+02	52	6895	6946	36219	36168	52	0
NC_010807.alt1	NC_010807.alt3	97.7778	45	24766	24810	3579	3623	44	1
NC_010807.alt1	NC_010807.alt3	1e+02	38	15638	15675	1401	1438	38	0
NC_010807.alt1	NC_010807.ref	99.8399	7494	24883	32376	24883	32376	7482	12
NC_010807.alt1	NC_010807.ref	99.7003	6339	32477	38815	32477	38815	6320	19
NC_010807.alt1	NC_010807.ref	99.7788	5426	19340	24765	19340	24765	5414	12
NC_010807.alt1	NC_010807.ref	99.4305	3336	6895	10230	7521	10856	3317	19
NC_010807.alt1	NC_010807.ref	99.8184	2753	11551	14303	12113	14865	2748	5
NC_010807.alt1	NC_010807.ref	99.7668	2573	2629	5201	3255	5827	2567	6
NC_010807.alt1	NC_010807.ref	99.7616	2097	15678	17774	15794	17890	2092	5
NC_010807.alt1	NC_010807.ref	99.7076	2052	577	2628	1023	3074	2046	6
NC_010807.alt1	NC_010807.ref	99.5918	1470	5323	6792	5949	7418	1464	6
NC_010807.alt1	NC_010807.ref	99.7039	1351	17874	19224	17990	19340	1347	4
NC_010807.alt1	NC_010807.ref	99.8246	1140	10231	11370	10973	12112	1138	2
NC_010807.alt1	NC_010807.ref	1e+02	928	14588	15515	14866	15793	928	0
NC_010807.alt1	NC_010807.ref	1e+02	468	109	576	393	860	468	0
NC_010807.alt1	NC_010807.ref	1e+02	284	14304	14587	392	109	284	0
NC_010807.alt1	NC_010807.ref	1e+02	180	11371	11550	3075	3254	180	0
NC_010807.alt1	NC_010807.ref	1e+02	162	15516	15677	861	1022	162	0
NC_010807.alt1	NC_010807.ref	1e+02	121	5202	5322	5948	5828	121	0
NC_010807.alt1	NC_010807.ref	98.2906	117	24766	24882	24873	24757	115	2
NC_010807.alt1	NC_010807.ref	1e+02	115	19225	19339	10967	10853	115	0
NC_010807.alt1	NC_010807.ref	99.0741	108	1	108	1	108	107	1
NC_010807.alt1	NC_010807.ref	1e+02	102	6793	6894	7520	7419	102	0
NC_010807.alt1	NC_010807.ref	1e+02	100	32377	32476	32475	32376	100	0
NC_010807.alt1	NC_010807.ref	1e+02	99	17775	17873	17988	17890	99	0
NC_010807.alt3	NC_005091.alt2	47.5728	103	34650	34752	28996	28872	49	54
NC_010807.alt3	NC_005091.alt2	51.6484	91	19104	19194	21819	21884	47	44
NC_010807.alt3	NC_005091.alt2	44.7761	67	23425	23491	23328	23405	30	37
NC_010807.alt3	NC_005091.alt2	50.7692	65	20803	20867	15544	15627	33	32
NC_010807.alt3	NC_005091.alt2	39.0625	64	24970	25033	54994	54939	25	39
NC_010807.alt3	NC_005091.alt2	54.6875	64	35116	35179	61883	61811	35	29
NC_010807.alt3	NC_005091.alt2	6e+01	60	15511	15570	18224	18173	36	24
NC_010807.alt3	NC_005091.alt2	43.1034	58	20032	20089	46652	46605	25	33
NC_010807.alt3	NC_005091.alt2	53.4483	58	36939	36996	48234	48187	31	27
NC_010807.alt3	NC_005091.alt2	53.4483	58	38745	38802	34100	34036	31	27
NC_010807.alt3	NC_005091.alt2	63.1579	57	15660	15716	23007	23079	36	21
NC_010807.alt3	NC_005091.alt2	50.8772	57	30207	30263	36884	36844	29	28
NC_010807.alt3	NC_005091.alt2	46.4286	56	23809	23864	27033	27126	26	30
NC_010807.alt3	NC_005091.alt2	53.7037	54	27890	27943	29212	29168	29	25
NC_010807.alt3	NC_005091.alt2	66.6667	54	30759	30812	3124	3184	36	18
NC_010807.alt3	NC_005091.alt2	52.8302	53	10700	10752	14575	14506	28	25
NC_010807.alt3	NC_005091.alt2	51.9231	52	36374	36425	53237	53202	27	25
NC_010807.alt3	NC_005091.alt2	60.7843	51	19544	19594	43638	43599	31	20
NC_010807.alt3	NC_005091.alt2	54.9020	51	38813	38863	17062	17098	28	23
NC_010807.alt3	NC_005091.alt2	5e+01	50	13090	13139	56921	56880	25	25
NC_010807.alt3	NC_005091.alt2	64	50	17027	17076	55482	55402	32	18
NC_010807.alt3	NC_005091.alt2	55.1020	49	3337	3385	60980	60935	27	22
NC_010807.alt3	NC_005091.alt2	43.75	48	14271	14318	33121	33083	21	27
NC_010807.alt3	NC_005091.alt2	61.7021	47	1545	1591	13198	13280	29	18
NC_010807.alt3	NC_005091.alt2	57.4468	47	29406	29452	18743	18827	27	20
NC_010807.alt3	NC_005091.alt2	62.2222	45	4821	4865	52529	52482	28	17
NC_010807.alt3	NC_005091.alt2	65.9091	44	11735	11778	47631	47588	29	15
NC_010807.alt3	NC_005091.alt2	59.0909	44	16875	16918	23470	23532	26	18
NC_010807.alt3	NC_005091.alt2	59.0909	44	26180	26223	61286	61317	26	18
NC_010807.alt3	NC_005091.alt2	58.1395	43	1826	1868	23421	23375	25	18
NC_010807.alt3	NC_005091.alt2	66.6667	42	11073	11114	51080	51041	28	14
NC_010807.alt3	NC_005091.alt2	6e+01	40	1958	1997	7283	7239	24	16
NC_010807.alt3	NC_005091.alt2	57.5	40	17083	17122	60688	60719	23	17
NC_010807.alt3	NC_005091.alt2	62.5	40	29101	29140	17715	17785	25	15
NC_010807.alt3	NC_005091.alt2	58.9744	39	22494	22532	8070	8029	23	16
NC_010807.alt3	NC_005091.alt2	66.6667	39	28051	28089	45313	45266	26	13
NC_010807.alt3	NC_005091.alt2	65.7895	38	11035	11072	22727	22669	25	13
NC_010807.alt3	NC_005091.alt2	68.4211	38	27339	27376	37131	37090	26	12
NC_010807.alt3	NC_005091.alt2	76.3158	38	39329	39366	36844	36913	29	9
NC_010807.alt3	NC_005091.alt2	75.6757	37	21341	21377	36212	36143	28	9
NC_010807.alt3	NC_005091.alt2	64.8649	37	24551	24587	53254	53207	24	13
NC_010807.alt3	NC_005091.alt2	69.4444	36	8172	8207	36409	36467	25	11
NC_010807.ref	NC_010807.alt3	99.7145	3503	8624	12126	8840	12342	3493	10
NC_010807.ref	NC_010807.alt3	99.7009	3009	29681	32689	29933	32941	3000	9
NC_010807.ref	NC_010807.alt3	99.9015	2031	19781	21811	20102	22132	2029	2
NC_010807.ref	NC_010807.alt3	99.7845	1856	26371	28226	26510	28365	1852	4
NC_010807.ref	NC_010807.alt3	99.7222	1800	15127	16926	15380	17179	1795	5
NC_010807.ref	NC_010807.alt3	99.6339	1639	32690	34328	33173	34811	1633	6
NC_010807.ref	NC_010807.alt3	99.6276	1611	21812	23422	22242	23852	1605	6
NC_010807.ref	NC_010807.alt3	99.8131	1605	983	2587	1401	3005	1602	3
NC_010807.ref	NC_010807.alt3	99.8102	1581	37235	38815	38311	39891	1578	3
NC_010807.ref	NC_010807.alt3	99.7932	1451	16927	18377	17364	18814	1448	3
NC_010807.ref	NC_010807.alt3	99.6942	1308	13819	15126	13872	15179	1304	4
NC_010807.ref	NC_010807.alt3	99.7678	1292	28389	29680	28366	29657	1289	3
NC_010807.ref	NC_010807.alt3	99.76	1250	23586	24835	24209	25458	1247	3
NC_010807.ref	NC_010807.alt3	99.6787	1245	3093	4337	3740	4984	1241	4
NC_010807.ref	NC_010807.alt3	1e+02	1145	4543	5687	4980	6124	1145	0
NC_010807.ref	NC_010807.alt3	1e+02	1051	7573	8623	7651	8701	1051	0
NC_010807.ref	NC_010807.alt3	99.6051	1013	12221	13233	12342	13354	1009	4
NC_010807.ref	NC_010807.alt3	99.2282	907	18378	19284	19025	19931	900	7
NC_010807.ref	NC_010807.alt3	99.3351	752	231	982	447	1198	747	5
NC_010807.ref	NC_010807.alt3	99.7159	704	35582	36285	36380	37083	702	2
NC_010807.ref	NC_010807.alt3	99.8311	592	6769	7360	7059	7650	591	1
NC_010807.ref	NC_010807.alt3	99.8205	557	25112	25668	25458	26014	556	1
NC_010807.ref	NC_010807.alt3	1e+02	520	35062	35581	35648	36167	520	0
NC_010807.ref	NC_010807.alt3	99.7980	495	25778	26272	26015	26509	494	1
NC_010807.ref	NC_010807.alt3	99.7831	461	13358	13818	13368	13828	460	1
NC_010807.ref	NC_010807.alt3	99.5595	454	34329	34782	34910	35363	452	2
NC_010807.ref	NC_010807.alt3	1e+02	426	5805	6230	6127	6552	426	0
NC_010807.ref	NC_010807.alt3	99.75	400	6369	6768	6553	6952	399	1
NC_010807.ref	NC_010807.alt3	99.7290	369	36521	36889	37757	38125	368	1
NC_010807.ref	NC_010807.alt3	1e+02	276	24836	25111	3616	3341	276	0
NC_010807.ref	NC_010807.alt3	1e+02	275	36960	37234	29932	29658	275	0
NC_010807.ref	NC_010807.alt3	1e+02	235	36286	36520	37294	37528	235	0
NC_010807.ref	NC_010807.alt3	1e+02	230	1	230	39662	39891	230	0
NC_010807.ref	NC_010807.alt3	1e+02	218	19285	19502	37539	37756	218	0
NC_010807.ref	NC_010807.alt3	1e+02	212	7361	7572	36379	36168	212	0
NC_010807.ref	NC_010807.alt3	1e+02	205	4338	4542	37287	37083	205	0
NC_010807.ref	NC_010807.alt3	1e+02	200	2893	3092	19014	18815	200	0
NC_010807.ref	NC_010807.alt3	1e+02	174	2588	2761	3168	3341	174	0
NC_010807.ref	NC_010807.alt3	99.4220	173	34783	34955	35475	35647	172	1
NC_010807.ref	NC_010807.alt3	1e+02	172	19503	19674	19922	20093	172	0
NC_010807.ref	NC_010807.alt3	1e+02	163	23423	23585	23948	24110	163	0
NC_010807.ref	NC_010807.alt3	1e+02	162	28227	28388	3005	3166	162	0
NC_010807.ref	NC_010807.alt3	1e+02	138	6231	6368	8839	8702	138	0
NC_010807.ref	NC_010807.alt3	96.9466	131	2762	2892	3619	3749	127	4
NC_010807.ref	NC_010807.alt3	94.3548	124	13234	13357	35363	35486	117	7
NC_010807.ref	NC_010807.alt3	1e+02	115	5688	5802	38239	38125	115	0
NC_010807.ref	NC_010807.alt3	1e+02	109	25669	25777	22241	22133	109	0
NC_010807.ref	NC_010807.alt3	95.2830	106	19675	19780	24111	24216	101	5
NC_010807.ref	NC_010807.alt3	1e+02	106	34956	35061	6953	7058	106	0
NC_010807.ref	NC_010807.alt3	1e+02	98	26273	26370	34812	34909	98	0
NC_010807.ref	NC_010807.alt3	1e+02	94	12127	12220	23854	23947	94	0
NC_010807.ref	NC_010807.alt3	1e+02	70	36890	36959	38241	38310	70	0
NC_010807.ref	NC_002486.alt	41.1765	68	36448	36515	29989	30045	28	40
NC_010807.ref	NC_002486.alt	54.8387	62	27238	27299	43842	43790	34	28
NC_010807.ref	NC_002486.alt	44.8276	58	24500	24557	24927	24975	26	32
NC_010807.ref	NC_002486.alt	56.8966	58	34843	34900	36838	36909	33	25
NC_010807.ref	NC_002486.alt	66.0714	56	13052	13107	25560	25641	37	19
NC_010807.ref	NC_002486.alt	48.0769	52	20679	20730	6147	6188	25	27
NC_010807.ref	NC_002486.alt	5e+01	52	29196	29247	27186	27147	26	26
NC_010807.ref	NC_002486.alt	54.9020	51	15646	15696	28769	28727	28	23
NC_010807.ref	NC_002486.alt	40.8163	49	7255	7303	21638	21599	20	29
NC_010807.ref	NC_002486.alt	62.5	48	13866	13913	43666	43749	30	18
NC_010807.ref	NC_002486.alt	66.6667	48	15818	15865	3685	3649	32	16
NC_010807.ref	NC_002486.alt	66.6667	48	17863	17910	18650	18538	32	16
NC_010807.ref	NC_002486.alt	48.9362	47	29464	29510	12212	12175	23	24
NC_010807.ref	NC_002486.alt	40.4255	47	32838	32884	2607	2646	19	28
NC_010807.ref	NC_002486.alt	66.6667	45	17919	17963	8496	8417	30	15
NC_010807.ref	NC_002486.alt	6e+01	45	17972	18016	33067	33006	27	18
NC_010807.ref	NC_002486.alt	66.6667	45	21186	21230	23804	23727	30	15
NC_010807.ref	NC_002486.alt	47.6190	42	9302	9343	38285	38318	20	22
NC_010807.ref	NC_002486.alt	69.0476	42	28313	28354	2465	2519	29	13
NC_010807.ref	NC_002486.alt	60.9756	41	34622	34662	19444	19388	25	16
NC_010807.ref	NC_002486.alt	6e+01	40	24901	24940	39502	39539	24	16
NC_010807.ref	NC_002486.alt	71.7949	39	23450	23488	40930	40977	28	11
NC_010807.ref	NC_002486.ref	41.1765	68	36448	36515	15648	15592	28	40
NC_010807.ref	NC_002486.ref	54.8387	62	27238	27299	13418	13366	34	28
NC_010807.ref	NC_002486.ref	56.8966	58	34843	34900	6414	6485	33	25
NC_010807.ref	NC_002486.ref	66.0714	56	13052	13107	20077	19996	37	19
NC_010807.ref	NC_002486.ref	48.0769	52	20679	20730	36571	36612	25	27
NC_010807.ref	NC_002486.ref	5e+01	52	29196	29247	18451	18490	26	26
NC_010807.ref	NC_002486.ref	54.9020	51	15646	15696	16868	16910	28	23
NC_010807.ref	NC_002486.ref	40.8163	49	7255	7303	23999	24038	20	29
NC_010807.ref	NC_002486.ref	62.5	48	13866	13913	13242	13325	30	18
NC_010807.ref	NC_002486.ref	66.6667	48	15818	15865	34109	34073	32	16
NC_010807.ref	NC_002486.ref	66.6667	48	17863	17910	26987	27099	32	16
NC_010807.ref	NC_002486.ref	48.9362	47	29464	29510	42636	42599	23	24
NC_010807.ref	NC_002486.ref	40.4255	47	32838	32884	33031	33070	19	28
NC_010807.ref	NC_002486.ref	66.6667	45	17919	17963	38920	38841	30	15
NC_010807.ref	NC_002486.ref	6e+01	45	17972	18016	2643	2582	27	18
NC_010807.ref	NC_002486.ref	66.6667	45	21186	21230	21833	21910	30	15
NC_010807.ref	NC_002486.ref	47.6190	42	9302	9343	7861	7894	20	22
NC_010807.ref	NC_002486.ref	69.0476	42	28313	28354	32889	32943	29	13
NC_010807.ref	NC_002486.ref	60.9756	41	34622	34662	26193	26249	25	16
NC_010807.ref	NC_002486.ref	6e+01	40	24901	24940	9078	9115	24	16
NC_010807.ref	NC_002486.ref	71.7949	39	23450	23488	10506	10553	28	11
NC_010807.alt1	NC_005091.ref	53.9474	76	16506	16581	20995	21083	41	35
NC_010807.alt1	NC_005091.ref	61.8421	76	28542	28617	17715	17812	47	29
NC_010807.alt1	NC_005091.ref	60.5634	71	6830	6900	15207	15304	43	28
NC_010807.alt1	NC_005091.ref	45.0704	71	22171	22241	44070	44018	32	39
NC_010807.alt1	NC_005091.ref	49.2308	65	14834	14898	54899	54951	32	33
NC_010807.alt1	NC_005091.ref	58.4615	65	27738	27802	31486	31433	38	27
NC_010807.alt1	NC_005091.ref	39.0625	64	24347	24410	50075	50020	25	39
NC_010807.alt1	NC_005091.ref	59.6774	62	20955	21016	48484	48411	37	25
NC_010807.alt1	NC_005091.ref	59.0164	61	32540	32600	53433	53378	36	25
NC_010807.alt1	NC_005091.ref	53.3333	60	8449	8508	20588	20544	32	28
NC_010807.alt1	NC_005091.ref	53.4483	58	5610	5667	26171	26251	31	27
NC_010807.alt1	NC_005091.ref	50.8772	57	29955	30011	33320	33280	29	28
NC_010807.alt1	NC_005091.ref	41.8182	55	19617	19671	42608	42565	23	32
NC_010807.alt1	NC_005091.ref	61.1111	54	2979	3032	51521	51441	33	21
NC_010807.alt1	NC_005091.ref	66.6667	54	30507	30560	38152	38212	36	18
NC_010807.alt1	NC_005091.ref	51.8519	54	31246	31299	53778	53736	28	26
NC_010807.alt1	NC_005091.ref	5e+01	52	22024	22075	16680	16752	26	26
NC_010807.alt1	NC_005091.ref	62.7451	51	18781	18831	39509	39470	32	19
NC_010807.alt1	NC_005091.ref	61.2245	49	9402	9450	4343	4300	30	19
NC_010807.alt1	NC_005091.ref	53.0612	49	22096	22144	30089	30133	26	23
NC_010807.alt1	NC_005091.ref	66.6667	48	13776	13823	2959	3024	32	16
NC_010807.alt1	NC_005091.ref	64.5833	48	31671	31718	47085	47170	31	17
NC_010807.alt1	NC_005091.ref	52.0833	48	32435	32482	8673	8633	25	23
NC_010807.alt1	NC_005091.ref	55.3191	47	16994	17040	36721	36687	26	21
NC_010807.alt1	NC_005091.ref	62.2222	45	18387	18431	9129	9194	28	17
NC_010807.alt1	NC_005091.ref	72.7273	44	6462	6505	4493	4444	32	12
NC_010807.alt1	NC_005091.ref	65.9091	44	31151	31194	55654	55704	29	15
NC_010807.alt1	NC_005091.ref	56.8182	44	31736	31779	27791	27821	25	19
NC_010807.alt1	NC_005091.ref	66.6667	42	6043	6084	42608	42671	28	14
NC_010807.alt1	NC_005091.ref	61.9048	42	20880	20921	53075	52995	26	16
NC_010807.alt1	NC_005091.ref	76.1905	42	24980	25021	54619	54694	32	10
NC_010807.alt1	NC_005091.ref	64.2857	42	36186	36227	32689	32621	27	15
NC_010807.alt1	NC_005091.ref	62.5	40	1094	1133	6605	6561	25	15
NC_010807.alt1	NC_005091.ref	65	40	15694	15733	19770	19692	26	14
NC_010807.alt1	NC_005091.ref	48.7179	39	5265	5303	50858	50889	19	20
NC_010807.alt1	NC_005091.ref	71.0526	38	2532	2569	44475	44530	27	11
NC_010807.alt1	NC_005091.ref	69.4444	36	7468	7503	32845	32903	25	11
NC_010807.alt1	NC_005091.ref	75	36	10484	10519	34805	34758	27	9
NC_010807.alt1	NC_005091.ref	66.6667	36	19424	19459	50324	50297	24	12
NC_010807.alt1	NC_005091.ref	71.4286	35	24090	24124	26910	26950	25	10
NC_010807.ref	NC_025457.ref	61.7647	102	4944	5045	20785	20924	63	39
NC_010807.ref	NC_025457.ref	55.9524	84	23647	23730	29055	29154	47	37
NC_010807.ref	NC_025457.ref	55.5556	72	32975	33046	37093	37011	40	32
NC_010807.ref	NC_025457.ref	55.5556	63	16840	16902	37857	37953	35	28
NC_010807.ref	NC_025457.ref	51.6667	60	22125	22184	28085	28165	31	29
NC_010807.ref	NC_025457.ref	60.3448	58	8757	8814	18932	19020	35	23
NC_010807.ref	NC_025457.ref	67.2414	58	11076	11133	17573	17683	39	19
NC_010807.ref	NC_025457.ref	56.8966	58	13398	13455	26948	27023	33	25
NC_010807.ref	NC_025457.ref	42.1053	57	11715	11771	21990	21941	24	33
NC_010807.ref	NC_025457.ref	57.8947	57	29778	29834	34483	34530	33	24
NC_010807.ref	NC_025457.ref	49.0909	55	15944	15998	27247	27288	27	28
NC_010807.ref	NC_025457.ref	55.7692	52	9738	9789	4950	4883	29	23
NC_010807.ref	NC_025457.ref	48.0769	52	11443	11494	3593	3635	25	27
NC_010807.ref	NC_025457.ref	57.6923	52	30982	31033	2464	2411	30	22
NC_010807.ref	NC_025457.ref	56.8627	51	8154	8204	4838	4879	29	22
NC_010807.ref	NC_025457.ref	52.9412	51	31487	31537	25802	25855	27	24
NC_010807.ref	NC_025457.ref	58.8235	51	37482	37532	11884	11937	30	21
NC_010807.ref	NC_025457.ref	72.9167	48	20575	20622	12743	12798	35	13
NC_010807.ref	NC_025457.ref	56.25	48	24660	24707	35479	35441	27	21
NC_010807.ref	NC_025457.ref	60.4167	48	28027	28074	4066	4010	29	19
NC_010807.ref	NC_025457.ref	63.0435	46	28158	28203	23967	24030	29	17
NC_010807.ref	NC_025457.ref	55.5556	45	4618	4662	33858	33894	25	20
NC_010807.ref	NC_025457.ref	53.3333	45	6000	6044	25297	25331	24	21
NC_010807.ref	NC_025457.ref	66.6667	45	9808	9852	6710	6788	30	15
NC_010807.ref	NC_025457.ref	55.5556	45	9999	10043	35806	35843	25	20
NC_010807.ref	NC_025457.ref	68.8889	45	19865	19909	24112	24148	31	14
NC_010807.ref	NC_025457.ref	64.4444	45	26117	26161	30934	30893	29	16
NC_010807.ref	NC_025457.ref	67.5	40	5533	5572	10479	10529	27	13
NC_010807.ref	NC_025457.ref	64.1026	39	17944	17982	40994	41068	25	14
NC_010807.ref	NC_025457.ref	64.1026	39	18981	19019	34344	34406	25	14
NC_010807.ref	NC_025457.ref	66.6667	39	25045	25083	41327	41387	26	13
NC_010807.ref	NC_025457.ref	55.2632	38	1702	1739	23227	23262	21	17
NC_010807.ref	NC_025457.ref	62.1622	37	19741	19777	40626	40662	23	14
NC_010807.ref	NC_025457.ref	69.4444	36	7347	7382	9865	9826	25	11
NC_010807.ref	NC_025457.ref	69.4444	36	9470	9505	23927	23956	25	11
NC_010807.ref	NC_025457.ref	71.4286	35	18842	18876	12874	12918	25	10
NC_010807.ref	NC_025457.ref	6e+01	35	24431	24465	32499	32533	21	14
NC_010807.alt1	NC_005091.alt1	53.9474	76	16506	16581	20995	21083	41	35
NC_010807.alt1	NC_005091.alt1	61.8421	76	28542	28617	17715	17812	47	29
NC_010807.alt1	NC_005091.alt1	56.0606	66	4356	4421	47072	46992	37	29
NC_010807.alt1	NC_005091.alt1	58.0645	62	20955	21016	48646	48573	36	26
NC_010807.alt1	NC_005091.alt1	44.2623	61	28057	28117	30289	30333	27	34
NC_010807.alt1	NC_005091.alt1	53.3333	60	10693	10752	48876	48816	32	28
NC_010807.alt1	NC_005091.alt1	49.1525	59	8449	8507	20588	20540	29	30
NC_010807.alt1	NC_005091.alt1	50.8772	57	29955	30011	33626	33585	29	28
NC_010807.alt1	NC_005091.alt1	51.7857	56	36670	36725	1442	1524	29	27
NC_010807.alt1	NC_005091.alt1	41.8182	55	19617	19671	42914	42871	23	32
NC_010807.alt1	NC_005091.alt1	46.2963	54	18150	18203	45995	45952	25	29
NC_010807.alt1	NC_005091.alt1	66.6667	54	30507	30560	38458	38518	36	18
NC_010807.alt1	NC_005091.alt1	5e+01	54	31246	31299	54027	53985	27	27
NC_010807.alt1	NC_005091.alt1	47.1698	53	38319	38371	6608	6667	25	28
NC_010807.alt1	NC_005091.alt1	60.7843	51	18781	18831	39815	39776	31	20
NC_010807.alt1	NC_005091.alt1	66.6667	51	23814	23864	15290	15331	34	17
NC_010807.alt1	NC_005091.alt1	6e+01	50	15376	15425	43569	43492	30	20
NC_010807.alt1	NC_005091.alt1	63.2653	49	9402	9450	4343	4300	31	18
NC_010807.alt1	NC_005091.alt1	52.0833	48	32435	32482	8673	8633	25	23
NC_010807.alt1	NC_005091.alt1	55.3191	47	16994	17040	37027	36993	26	21
NC_010807.alt1	NC_005091.alt1	59.5745	47	17059	17105	9546	9461	28	19
NC_010807.alt1	NC_005091.alt1	46.6667	45	3841	3885	35131	35058	21	24
NC_010807.alt1	NC_005091.alt1	6e+01	45	11701	11745	54804	54875	27	18
NC_010807.alt1	NC_005091.alt1	65.9091	44	28666	28709	47882	47963	29	15
NC_010807.alt1	NC_005091.alt1	66.6667	42	11641	11682	36783	36821	28	14
NC_010807.alt1	NC_005091.alt1	71.4286	42	24980	25021	54619	54694	30	12
NC_010807.alt1	NC_005091.alt1	7e+01	40	13911	13950	8084	8159	28	12
NC_010807.alt1	NC_005091.alt1	48.7179	39	5265	5303	51107	51138	19	20
NC_010807.alt1	NC_005091.alt1	58.9744	39	14051	14089	32788	32821	23	16
NC_010807.alt1	NC_005091.alt1	51.2821	39	16012	16050	44198	44169	20	19
NC_010807.alt1	NC_005091.alt1	69.2308	39	21132	21170	35656	35612	27	12
NC_010807.alt1	NC_005091.alt1	60.5263	38	21580	21617	29700	29667	23	15
NC_010807.alt1	NC_005091.alt1	63.8889	36	6499	6534	17975	17919	23	13
NC_010807.alt1	NC_005091.alt1	75	36	10484	10519	35111	35064	27	9
NC_010807.alt1	NC_005091.alt1	66.6667	36	19424	19459	50573	50546	24	12
NC_010807.alt1	NC_005091.alt1	62.8571	35	17943	17977	54412	54378	22	13
NC_010807.alt1	NC_005091.alt1	71.4286	35	24090	24124	26823	26863	25	10
NC_010807.alt2	NC_025457.alt2	53.4091	88	8114	8201	43810	43694	47	41
NC_010807.alt2	NC_025457.alt2	48.2759	87	25812	25898	30313	30238	42	45
NC_010807.alt2	NC_025457.alt2	46.25	80	19668	19747	4974	5035	37	43
NC_010807.alt2	NC_025457.alt2	54.5455	66	33984	34049	59899	59978	36	30
NC_010807.alt2	NC_025457.alt2	54.5455	66	34126	34191	59899	59978	36	30
NC_010807.alt2	NC_025457.alt2	45.4545	66	40222	40287	16719	16664	30	36
NC_010807.alt2	NC_025457.alt2	55.3846	65	35042	35106	40328	40444	36	29
NC_010807.alt2	NC_025457.alt2	58.4615	65	36777	36841	24543	24601	38	27
NC_010807.alt2	NC_025457.alt2	55.5556	63	9776	9838	33909	34007	35	28
NC_010807.alt2	NC_025457.alt2	59.0164	61	2150	2210	10482	10568	36	25
NC_010807.alt2	NC_025457.alt2	55.7377	61	12329	12389	7268	7367	34	27
NC_010807.alt2	NC_025457.alt2	61.0169	59	15387	15445	42126	42199	36	23
NC_010807.alt2	NC_025457.alt2	59.3220	59	26383	26441	14283	14351	35	24
NC_010807.alt2	NC_025457.alt2	63.7931	58	9051	9108	61743	61652	37	21
NC_010807.alt2	NC_025457.alt2	5e+01	58	15246	15303	14698	14781	29	29
NC_010807.alt2	NC_025457.alt2	58.6207	58	35604	35661	12213	12123	34	24
NC_010807.alt2	NC_025457.alt2	42.1053	57	12411	12467	33636	33587	24	33
NC_010807.alt2	NC_025457.alt2	57.8947	57	19063	19119	27752	27838	33	24
NC_010807.alt2	NC_025457.alt2	49.0909	55	27207	27261	49267	49312	27	28
NC_010807.alt2	NC_025457.alt2	55.5556	54	20172	20225	8359	8410	30	24
NC_010807.alt2	NC_025457.alt2	54.9020	51	16127	16177	38985	39046	28	23
NC_010807.alt2	NC_025457.alt2	54	50	10436	10485	6743	6678	27	23
NC_010807.alt2	NC_025457.alt2	63.2653	49	12595	12643	14729	14789	31	18
NC_010807.alt2	NC_025457.alt2	52.0833	48	22461	22508	18185	18152	25	23
NC_010807.alt2	NC_025457.alt2	47.9167	48	28705	28752	25541	25502	23	25
NC_010807.alt2	NC_025457.alt2	55.5556	45	5720	5764	35341	35277	25	20
NC_010807.alt2	NC_025457.alt2	6e+01	45	29460	29504	24526	24469	27	18
NC_010807.alt2	NC_025457.alt2	44.4444	45	29991	30035	29104	29141	20	25
NC_010807.alt2	NC_025457.alt2	6e+01	45	38255	38299	53662	53624	27	18
NC_010807.alt2	NC_025457.alt2	47.7273	44	13061	13104	10723	10761	21	23
NC_010807.alt2	NC_025457.alt2	59.0909	44	20483	20526	54195	54248	26	18
NC_010807.alt2	NC_025457.alt2	52.2727	44	21521	21564	9500	9531	23	21
NC_010807.alt2	NC_025457.alt2	62.7907	43	24680	24722	43684	43742	27	16
NC_010807.alt2	NC_025457.alt2	69.0476	42	10166	10207	36330	36374	29	13
NC_010807.alt2	NC_025457.alt2	73.8095	42	17364	17405	13208	13142	31	11
NC_010807.alt2	NC_025457.alt2	57.1429	42	25081	25122	41076	41109	24	18
NC_010807.alt2	NC_025457.alt2	59.5238	42	30833	30874	14449	14477	25	17
NC_010807.alt2	NC_025457.alt2	65.8537	41	17637	17677	58789	58854	27	14
NC_010807.alt2	NC_025457.alt2	60.9756	41	19210	19250	2292	2355	25	16
NC_010807.alt2	NC_025457.alt2	7e+01	40	5062	5101	1782	1743	28	12
NC_010807.alt2	NC_025457.alt2	65	40	29261	29300	52551	52495	26	14
NC_010807.alt2	NC_025457.alt2	57.5	40	39834	39873	56840	56918	23	17
NC_010807.alt2	NC_025457.alt2	64.1026	39	5169	5207	48596	48522	25	14
NC_010807.alt2	NC_025457.alt2	55.2632	38	1811	1848	23870	23835	21	17
NC_010807.alt2	NC_025457.alt2	65.7895	38	35125	35162	49210	49154	25	13
NC_010807.alt2	NC_025457.alt2	64.8649	37	14144	14180	23090	23164	24	13
NC_010807.alt2	NC_025457.alt2	59.4595	37	34404	34440	53968	53996	22	15
NC_010807.alt2	NC_025457.alt2	72.2222	36	11869	11904	3843	3815	26	10
NC_010807.alt2	NC_025457.alt2	61.1111	36	32429	32464	40653	40600	22	14
NC_010807.alt2	NC_025457.alt2	74.2857	35	5223	5257	31469	31503	26	9
NC_010807.alt2	NC_025457.alt2	71.4286	35	19786	19820	19790	19834	25	10
NC_010807.alt2	NC_025457.alt2	68.5714	35	37981	38015	31476	31442	24	11
NC_010807.alt1	NC_005091.alt2	47.5728	103	34167	34269	28996	28872	49	54
NC_010807.alt1	NC_005091.alt2	51.6484	91	18341	18431	21819	21884	47	44
NC_010807.alt1	NC_005091.alt2	52.7778	72	36879	36950	44142	44257	38	34
NC_010807.alt1	NC_005091.alt2	53.5211	71	6830	6900	16564	16661	38	33
NC_010807.alt1	NC_005091.alt2	44.7761	67	22995	23061	23328	23405	30	37
NC_010807.alt1	NC_005091.alt2	50.7692	65	20482	20546	15544	15627	33	32
NC_010807.alt1	NC_005091.alt2	39.0625	64	24347	24410	54994	54939	25	39
NC_010807.alt1	NC_005091.alt2	54.6875	64	34535	34598	61883	61811	35	29
NC_010807.alt1	NC_005091.alt2	59.0164	61	32540	32600	59022	58967	36	25
NC_010807.alt1	NC_005091.alt2	6e+01	60	14980	15039	18224	18173	36	24
NC_010807.alt1	NC_005091.alt2	43.1034	58	19613	19670	46652	46605	25	33
NC_010807.alt1	NC_005091.alt2	36.2069	58	22171	22228	48231	48181	21	37
NC_010807.alt1	NC_005091.alt2	53.4483	58	36141	36198	48234	48187	31	27
NC_010807.alt1	NC_005091.alt2	53.4483	58	37669	37726	34100	34036	31	27
NC_010807.alt1	NC_005091.alt2	63.1579	57	15129	15185	23007	23079	36	21
NC_010807.alt1	NC_005091.alt2	50.8772	57	29955	30011	36884	36844	29	28
NC_010807.alt1	NC_005091.alt2	52.6316	57	35054	35110	18544	18611	30	27
NC_010807.alt1	NC_005091.alt2	57.1429	56	34919	34974	33388	33307	32	24
NC_010807.alt1	NC_005091.alt2	55.5556	54	27751	27804	29212	29168	30	24
NC_010807.alt1	NC_005091.alt2	66.6667	54	30507	30560	3124	3184	36	18
NC_010807.alt1	NC_005091.alt2	61.1111	54	33477	33530	41164	41099	33	21
NC_010807.alt1	NC_005091.alt2	54.7170	53	9858	9910	14575	14506	29	24
NC_010807.alt1	NC_005091.alt2	60.7843	51	18781	18831	43638	43599	31	20
NC_010807.alt1	NC_005091.alt2	54.9020	51	37737	37787	17062	17098	28	23
NC_010807.alt1	NC_005091.alt2	5e+01	50	12407	12456	56921	56880	25	25
NC_010807.alt1	NC_005091.alt2	64	50	16658	16707	55482	55402	32	18
NC_010807.alt1	NC_005091.alt2	43.75	48	13656	13703	33121	33083	21	27
NC_010807.alt1	NC_005091.alt2	61.7021	47	681	727	13198	13280	29	18
NC_010807.alt1	NC_005091.alt2	57.4468	47	29429	29475	18743	18827	27	20
NC_010807.alt1	NC_005091.alt2	62.2222	45	3548	3592	52529	52482	28	17
NC_010807.alt1	NC_005091.alt2	46.6667	45	3841	3885	39049	38976	21	24
NC_010807.alt1	NC_005091.alt2	65.9091	44	10777	10820	47631	47588	29	15
NC_010807.alt1	NC_005091.alt2	59.0909	44	16506	16549	23470	23532	26	18
NC_010807.alt1	NC_005091.alt2	59.0909	44	25943	25986	61286	61317	26	18
NC_010807.alt1	NC_005091.alt2	65.9091	44	31151	31194	61757	61807	29	15
NC_010807.alt1	NC_005091.alt2	58.1395	43	962	1004	23421	23375	25	18
NC_010807.alt1	NC_005091.alt2	74.4186	43	24979	25021	60721	60797	32	11
NC_010807.alt1	NC_005091.alt2	69.0476	42	3132	3173	43199	43145	29	13
NC_010807.alt1	NC_005091.alt2	6e+01	40	1094	1133	7283	7239	24	16
NC_010807.alt1	NC_005091.alt2	57.5	40	5175	5214	12164	12241	23	17
NC_010807.alt1	NC_005091.alt2	57.5	40	16714	16753	60688	60719	23	17
NC_010807.alt1	NC_005091.alt2	62.5	40	29124	29163	17715	17785	25	15
NC_010807.alt1	NC_005091.alt2	74.3590	39	3690	3728	16130	16190	29	10
NC_010807.alt1	NC_005091.alt2	58.9744	39	22064	22102	8070	8029	23	16
NC_010807.alt1	NC_005091.alt2	66.6667	39	27912	27950	45313	45266	26	13
NC_010807.alt1	NC_005091.alt2	76.3158	38	38253	38290	36844	36913	29	9
NC_010807.alt1	NC_005091.alt2	75.6757	37	21020	21056	36212	36143	28	9
NC_010807.alt1	NC_005091.alt2	64.8649	37	23928	23964	53254	53207	24	13
NC_010807.alt1	NC_005091.alt2	69.4444	36	7468	7503	36409	36467	25	11
NC_010807.alt1	NC_005091.alt2	66.6667	36	34131	34166	2637	2709	24	12
NC_010807.alt2	NC_025457.alt1	55.5556	72	34428	34499	35485	35403	40	32
NC_010807.alt2	NC_025457.alt1	50.7246	69	23069	23137	27108	27197	35	34
NC_010807.alt2	NC_025457.alt1	54.4118	68	1624	1691	7457	7352	37	31
NC_010807.alt2	NC_025457.alt1	67.2414	58	11772	11829	16678	16788	39	19
NC_010807.alt2	NC_025457.alt1	47.3684	57	12308	12364	19647	19599	27	30
NC_010807.alt2	NC_025457.alt1	42.1053	57	12411	12467	20795	20746	24	33
NC_010807.alt2	NC_025457.alt1	47.3684	57	32509	32565	26399	26314	27	30
NC_010807.alt2	NC_025457.alt1	47.2727	55	9450	9504	6072	6152	26	29
NC_010807.alt2	NC_025457.alt1	57.4074	54	20172	20225	29693	29744	31	23
NC_010807.alt2	NC_025457.alt1	52.9412	51	32798	32848	24429	24482	27	24
NC_010807.alt2	NC_025457.alt1	58.8235	51	39222	39272	11255	11308	30	21
NC_010807.alt2	NC_025457.alt1	61.2245	49	38958	39006	16408	16350	30	19
NC_010807.alt2	NC_025457.alt1	72.9167	48	21519	21566	11844	11899	35	13
NC_010807.alt2	NC_025457.alt1	56.25	48	25693	25740	33568	33530	27	21
NC_010807.alt2	NC_025457.alt1	60.4167	48	29060	29107	3627	3571	29	19
NC_010807.alt2	NC_025457.alt1	68.8889	45	20809	20853	23184	23220	31	14
NC_010807.alt2	NC_025457.alt1	73.8095	42	786	827	16917	16959	31	11
NC_010807.alt2	NC_025457.alt1	70.7317	41	24968	25008	38020	38079	29	12
NC_010807.alt2	NC_025457.alt1	65	40	16524	16563	24162	24097	26	14
NC_010807.alt2	NC_025457.alt1	72.5	40	23662	23701	38006	38057	29	11
NC_010807.alt2	NC_025457.alt1	72.5	40	39074	39113	23059	23001	29	11
NC_010807.alt2	NC_025457.alt1	57.8947	38	1811	1848	22002	22037	22	16
NC_010807.alt2	NC_025457.alt1	68.4211	38	19689	19726	19847	19810	26	12
NC_010807.alt2	NC_025457.alt1	57.8947	38	25644	25681	15646	15676	22	16
NC_010807.alt2	NC_025457.alt1	69.4444	36	19880	19915	12595	12560	25	11
NC_010807.alt2	NC_025457.alt1	77.1429	35	8671	8705	30792	30831	27	8
NC_010807.ref	NC_005091.ref	53.9474	76	16622	16697	20995	21083	41	35
NC_010807.ref	NC_005091.ref	61.8421	76	28542	28617	17715	17812	47	29
NC_010807.ref	NC_005091.ref	45.0704	71	22171	22241	44070	44018	32	39
NC_010807.ref	NC_005091.ref	49.2308	65	15112	15176	54899	54951	32	33
NC_010807.ref	NC_005091.ref	58.4615	65	27738	27802	31486	31433	38	27
NC_010807.ref	NC_005091.ref	39.0625	64	24347	24410	50075	50020	25	39
NC_010807.ref	NC_005091.ref	59.6774	62	20955	21016	48484	48411	37	25
NC_010807.ref	NC_005091.ref	53.3333	60	3029	3088	55307	55399	32	28
NC_010807.ref	NC_005091.ref	53.3333	60	9075	9134	20588	20544	32	28
NC_010807.ref	NC_005091.ref	53.4483	58	6236	6293	26171	26251	31	27
NC_010807.ref	NC_005091.ref	50.8772	57	29955	30011	33320	33280	29	28
NC_010807.ref	NC_005091.ref	46.4286	56	2505	2560	56071	56115	26	30
NC_010807.ref	NC_005091.ref	41.8182	55	19617	19671	42608	42565	23	32
NC_010807.ref	NC_005091.ref	61.1111	54	3605	3658	51521	51441	33	21
NC_010807.ref	NC_005091.ref	66.6667	54	30507	30560	38152	38212	36	18
NC_010807.ref	NC_005091.ref	51.8519	54	31246	31299	53778	53736	28	26
NC_010807.ref	NC_005091.ref	5e+01	52	22024	22075	16680	16752	26	26
NC_010807.ref	NC_005091.ref	62.7451	51	18897	18947	39509	39470	32	19
NC_010807.ref	NC_005091.ref	61.2245	49	10028	10076	4343	4300	30	19
NC_010807.ref	NC_005091.ref	53.0612	49	22096	22144	30089	30133	26	23
NC_010807.ref	NC_005091.ref	66.6667	48	14338	14385	2959	3024	32	16
NC_010807.ref	NC_005091.ref	64.5833	48	31671	31718	47085	47170	31	17
NC_010807.ref	NC_005091.ref	55.3191	47	10810	10856	20261	20194	26	21
NC_010807.ref	NC_005091.ref	68.0851	47	10857	10903	46522	46437	32	15
NC_010807.ref	NC_005091.ref	55.3191	47	17110	17156	36721	36687	26	21
NC_010807.ref	NC_005091.ref	62.2222	45	18503	18547	9129	9194	28	17
NC_010807.ref	NC_005091.ref	65.9091	44	31151	31194	55654	55704	29	15
NC_010807.ref	NC_005091.ref	56.8182	44	31736	31779	27791	27821	25	19
NC_010807.ref	NC_005091.ref	66.6667	42	6669	6710	42608	42671	28	14
NC_010807.ref	NC_005091.ref	61.9048	42	20880	20921	53075	52995	26	16
NC_010807.ref	NC_005091.ref	76.1905	42	24980	25021	54619	54694	32	10
NC_010807.ref	NC_005091.ref	64.2857	42	36186	36227	32689	32621	27	15
NC_010807.ref	NC_005091.ref	62.5	40	1540	1579	6605	6561	25	15
NC_010807.ref	NC_005091.ref	65	40	15810	15849	19770	19692	26	14
NC_010807.ref	NC_005091.ref	71.0526	38	2978	3015	44475	44530	27	11
NC_010807.ref	NC_005091.ref	69.4444	36	8094	8129	32845	32903	25	11
NC_010807.ref	NC_005091.ref	75	36	11226	11261	34805	34758	27	9
NC_010807.ref	NC_005091.ref	66.6667	36	19424	19459	50324	50297	24	12
NC_010807.ref	NC_005091.ref	71.4286	35	24090	24124	26910	26950	25	10
NC_010807.ref	NC_005091.alt1	53.9474	76	16622	16697	20995	21083	41	35
NC_010807.ref	NC_005091.alt1	56.0606	66	4982	5047	47072	46992	37	29
NC_010807.ref	NC_005091.alt1	58.0645	62	20955	21016	48646	48573	36	26
NC_010807.ref	NC_005091.alt1	44.2623	61	28057	28117	30289	30333	27	34
NC_010807.ref	NC_005091.alt1	53.3333	60	3029	3088	55307	55399	32	28
NC_010807.ref	NC_005091.alt1	53.3333	60	11435	11494	48876	48816	32	28
NC_010807.ref	NC_005091.alt1	49.1525	59	9075	9133	20588	20540	29	30
NC_010807.ref	NC_005091.alt1	50.8772	57	29955	30011	33626	33585	29	28
NC_010807.ref	NC_005091.alt1	48.2143	56	2505	2560	56071	56115	27	29
NC_010807.ref	NC_005091.alt1	51.7857	56	36670	36725	1442	1524	29	27
NC_010807.ref	NC_005091.alt1	41.8182	55	19617	19671	42914	42871	23	32
NC_010807.ref	NC_005091.alt1	46.2963	54	18266	18319	45995	45952	25	29
NC_010807.ref	NC_005091.alt1	66.6667	54	30507	30560	38458	38518	36	18
NC_010807.ref	NC_005091.alt1	5e+01	54	31246	31299	54027	53985	27	27
NC_010807.ref	NC_005091.alt1	66.0377	53	28542	28594	17715	17792	35	18
NC_010807.ref	NC_005091.alt1	47.1698	53	38319	38371	6608	6667	25	28
NC_010807.ref	NC_005091.alt1	60.7843	51	18897	18947	39815	39776	31	20
NC_010807.ref	NC_005091.alt1	66.6667	51	23814	23864	15290	15331	34	17
NC_010807.ref	NC_005091.alt1	6e+01	50	15654	15703	43569	43492	30	20
NC_010807.ref	NC_005091.alt1	63.2653	49	10028	10076	4343	4300	31	18
NC_010807.ref	NC_005091.alt1	53.0612	49	14603	14651	32778	32821	26	23
NC_010807.ref	NC_005091.alt1	55.3191	47	17110	17156	37027	36993	26	21
NC_010807.ref	NC_005091.alt1	59.5745	47	17175	17221	9546	9461	28	19
NC_010807.ref	NC_005091.alt1	46.6667	45	4467	4511	35131	35058	21	24
NC_010807.ref	NC_005091.alt1	6e+01	45	12263	12307	54804	54875	27	18
NC_010807.ref	NC_005091.alt1	65.9091	44	28666	28709	47882	47963	29	15
NC_010807.ref	NC_005091.alt1	66.6667	42	12203	12244	36783	36821	28	14
NC_010807.ref	NC_005091.alt1	73.8095	42	13793	13834	27186	27124	31	11
NC_010807.ref	NC_005091.alt1	71.4286	42	24980	25021	54619	54694	30	12
NC_010807.ref	NC_005091.alt1	7e+01	40	14473	14512	8084	8159	28	12
NC_010807.ref	NC_005091.alt1	51.2821	39	16128	16166	44198	44169	20	19
NC_010807.ref	NC_005091.alt1	69.2308	39	21132	21170	35656	35612	27	12
NC_010807.ref	NC_005091.alt1	60.5263	38	21580	21617	29700	29667	23	15
NC_010807.ref	NC_005091.alt1	67.5676	37	10714	10750	17216	17181	25	12
NC_010807.ref	NC_005091.alt1	63.8889	36	7125	7160	17975	17919	23	13
NC_010807.ref	NC_005091.alt1	75	36	11226	11261	35111	35064	27	9
NC_010807.ref	NC_005091.alt1	66.6667	36	19424	19459	50573	50546	24	12
NC_010807.ref	NC_005091.alt1	62.8571	35	18059	18093	54412	54378	22	13
NC_010807.ref	NC_005091.alt1	71.4286	35	24090	24124	26823	26863	25	10
NC_010807.ref	NC_005091.alt2	47.5728	103	34167	34269	28996	28872	49	54
NC_010807.ref	NC_005091.alt2	51.6484	91	18457	18547	21819	21884	47	44
NC_010807.ref	NC_005091.alt2	52.7778	72	36879	36950	44142	44257	38	34
NC_010807.ref	NC_005091.alt2	44.7761	67	22995	23061	23328	23405	30	37
NC_010807.ref	NC_005091.alt2	50.7692	65	20482	20546	15544	15627	33	32
NC_010807.ref	NC_005091.alt2	39.0625	64	24347	24410	54994	54939	25	39
NC_010807.ref	NC_005091.alt2	54.6875	64	34535	34598	61883	61811	35	29
NC_010807.ref	NC_005091.alt2	53.3333	60	3029	3088	61410	61502	32	28
NC_010807.ref	NC_005091.alt2	6e+01	60	15258	15317	18224	18173	36	24
NC_010807.ref	NC_005091.alt2	43.1034	58	19613	19670	46652	46605	25	33
NC_010807.ref	NC_005091.alt2	36.2069	58	22171	22228	48231	48181	21	37
NC_010807.ref	NC_005091.alt2	53.4483	58	36141	36198	48234	48187	31	27
NC_010807.ref	NC_005091.alt2	53.4483	58	37669	37726	34100	34036	31	27
NC_010807.ref	NC_005091.alt2	63.1579	57	15407	15463	23007	23079	36	21
NC_010807.ref	NC_005091.alt2	50.8772	57	29955	30011	36884	36844	29	28
NC_010807.ref	NC_005091.alt2	52.6316	57	35054	35110	18544	18611	30	27
NC_010807.ref	NC_005091.alt2	57.1429	56	34919	34974	33388	33307	32	24
NC_010807.ref	NC_005091.alt2	55.5556	54	27751	27804	29212	29168	30	24
NC_010807.ref	NC_005091.alt2	66.6667	54	30507	30560	3124	3184	36	18
NC_010807.ref	NC_005091.alt2	61.1111	54	33477	33530	41164	41099	33	21
NC_010807.ref	NC_005091.alt2	52.8302	53	10484	10536	14575	14506	28	25
NC_010807.ref	NC_005091.alt2	60.7843	51	18897	18947	43638	43599	31	20
NC_010807.ref	NC_005091.alt2	54.9020	51	37737	37787	17062	17098	28	23
NC_010807.ref	NC_005091.alt2	5e+01	50	12969	13018	56921	56880	25	25
NC_010807.ref	NC_005091.alt2	64	50	16774	16823	55482	55402	32	18
NC_010807.ref	NC_005091.alt2	43.75	48	14218	14265	33121	33083	21	27
NC_010807.ref	NC_005091.alt2	61.7021	47	1127	1173	13198	13280	29	18
NC_010807.ref	NC_005091.alt2	57.4468	47	29429	29475	18743	18827	27	20
NC_010807.ref	NC_005091.alt2	62.2222	45	4174	4218	52529	52482	28	17
NC_010807.ref	NC_005091.alt2	46.6667	45	4467	4511	39049	38976	21	24
NC_010807.ref	NC_005091.alt2	65.9091	44	11519	11562	47631	47588	29	15
NC_010807.ref	NC_005091.alt2	59.0909	44	16622	16665	23470	23532	26	18
NC_010807.ref	NC_005091.alt2	59.0909	44	25943	25986	61286	61317	26	18
NC_010807.ref	NC_005091.alt2	65.9091	44	31151	31194	61757	61807	29	15
NC_010807.ref	NC_005091.alt2	58.1395	43	1408	1450	23421	23375	25	18
NC_010807.ref	NC_005091.alt2	74.4186	43	24979	25021	60721	60797	32	11
NC_010807.ref	NC_005091.alt2	69.0476	42	3758	3799	43199	43145	29	13
NC_010807.ref	NC_005091.alt2	66.6667	42	10857	10898	51080	51041	28	14
NC_010807.ref	NC_005091.alt2	73.8095	42	13793	13834	29991	29929	31	11
NC_010807.ref	NC_005091.alt2	6e+01	40	1540	1579	7283	7239	24	16
NC_010807.ref	NC_005091.alt2	57.5	40	16830	16869	60688	60719	23	17
NC_010807.ref	NC_005091.alt2	62.5	40	29124	29163	17715	17785	25	15
NC_010807.ref	NC_005091.alt2	74.3590	39	4316	4354	16130	16190	29	10
NC_010807.ref	NC_005091.alt2	58.9744	39	22064	22102	8070	8029	23	16
NC_010807.ref	NC_005091.alt2	66.6667	39	27912	27950	45313	45266	26	13
NC_010807.ref	NC_005091.alt2	65.7895	38	10819	10856	22727	22669	25	13
NC_010807.ref	NC_005091.alt2	68.4211	38	27200	27237	37131	37090	26	12
NC_010807.ref	NC_005091.alt2	76.3158	38	38253	38290	36844	36913	29	9
NC_010807.ref	NC_005091.alt2	75.6757	37	21020	21056	36212	36143	28	9
NC_010807.ref	NC_005091.alt2	64.8649	37	23928	23964	53254	53207	24	13
NC_010807.ref	NC_005091.alt2	69.4444	36	8094	8129	36409	36467	25	11
NC_010807.alt3	NC_025457.alt2	45.4545	66	39558	39623	16719	16664	30	36
NC_010807.alt3	NC_025457.alt2	58.4615	65	35796	35860	24543	24601	38	27
NC_010807.alt3	NC_025457.alt2	59.3220	59	25696	25754	14283	14351	35	24
NC_010807.alt3	NC_025457.alt2	52.5424	59	39626	39684	5907	5860	31	28
NC_010807.alt3	NC_025457.alt2	63.7931	58	8433	8490	61743	61652	37	21
NC_010807.alt3	NC_025457.alt2	5e+01	58	14510	14567	14698	14781	29	29
NC_010807.alt3	NC_025457.alt2	58.6207	58	34520	34577	12213	12123	34	24
NC_010807.alt3	NC_025457.alt2	62.0690	58	38398	38455	5847	5794	36	22
NC_010807.alt3	NC_025457.alt2	42.1053	57	11931	11987	33636	33587	24	33
NC_010807.alt3	NC_025457.alt2	50.8772	57	25402	25458	30313	30262	29	28
NC_010807.alt3	NC_025457.alt2	49.0909	55	26411	26465	49267	49312	27	28
NC_010807.alt3	NC_025457.alt2	46.2963	54	10138	10191	28754	28798	25	29
NC_010807.alt3	NC_025457.alt2	54.9020	51	15591	15641	38985	39046	28	23
NC_010807.alt3	NC_025457.alt2	54	50	9956	10005	6743	6678	27	23
NC_010807.alt3	NC_025457.alt2	63.2653	49	12115	12163	14729	14789	31	18
NC_010807.alt3	NC_025457.alt2	60.4167	48	18062	18109	41689	41759	29	19
NC_010807.alt3	NC_025457.alt2	52.0833	48	21838	21885	18185	18152	25	23
NC_010807.alt3	NC_025457.alt2	45.8333	48	27811	27858	25541	25501	22	26
NC_010807.alt3	NC_025457.alt2	61.7021	47	645	691	37016	37060	29	18
NC_010807.alt3	NC_025457.alt2	55.5556	45	5879	5923	35341	35277	25	20
NC_010807.alt3	NC_025457.alt2	55.5556	45	15249	15293	62345	62405	25	20
NC_010807.alt3	NC_025457.alt2	6e+01	45	28404	28448	24526	24469	27	18
NC_010807.alt3	NC_025457.alt2	56.8182	44	1631	1674	8708	8740	25	19
NC_010807.alt3	NC_025457.alt2	59.0909	44	19958	20001	54195	54248	26	18
NC_010807.alt3	NC_025457.alt2	52.2727	44	20898	20941	9500	9531	23	21
NC_010807.alt3	NC_025457.alt2	69.0476	42	9686	9727	36330	36374	29	13
NC_010807.alt3	NC_025457.alt2	71.4286	42	16673	16714	13208	13142	30	12
NC_010807.alt3	NC_025457.alt2	57.1429	42	24671	24712	41076	41109	24	18
NC_010807.alt3	NC_025457.alt2	61.9048	42	29960	30001	14449	14477	26	16
NC_010807.alt3	NC_025457.alt2	63.4146	41	16946	16986	58789	58854	26	15
NC_010807.alt3	NC_025457.alt2	60.9756	41	18703	18743	2292	2355	25	16
NC_010807.alt3	NC_025457.alt2	70.7317	41	37102	37142	56419	56368	29	12
NC_010807.alt3	NC_025457.alt2	7e+01	40	5221	5260	1782	1743	28	12
NC_010807.alt3	NC_025457.alt2	57.5	40	39170	39209	56840	56918	23	17
NC_010807.alt3	NC_025457.alt2	64.1026	39	5328	5366	48596	48522	25	14
NC_010807.alt3	NC_025457.alt2	55.2632	38	2120	2157	23870	23835	21	17
NC_010807.alt3	NC_025457.alt2	71.0526	38	7056	7093	50752	50806	27	11
NC_010807.alt3	NC_025457.alt2	76.3158	38	13342	13379	38625	38575	29	9
NC_010807.alt3	NC_025457.alt2	64.8649	37	13458	13494	23090	23164	24	13
NC_010807.alt3	NC_025457.alt2	59.4595	37	33434	33470	53968	53996	22	15
NC_010807.alt3	NC_025457.alt2	72.2222	36	4121	4156	57805	57746	26	10
NC_010807.alt3	NC_025457.alt2	61.1111	36	31370	31405	40653	40600	22	14
NC_010807.alt3	NC_025457.alt2	74.2857	35	5382	5416	31469	31503	26	9
NC_010807.alt3	NC_025457.alt2	71.4286	35	19489	19523	19790	19834	25	10
NC_010807.alt3	NC_025457.alt1	55.5556	72	33458	33529	35485	35403	40	32
NC_010807.alt3	NC_025457.alt1	47.8261	69	22555	22623	27108	27197	33	36
NC_010807.alt3	NC_025457.alt1	54.4118	68	1933	2000	7457	7352	37	31
NC_010807.alt3	NC_025457.alt1	44.0678	59	23046	23104	34705	34751	26	33
NC_010807.alt3	NC_025457.alt1	67.2414	58	11292	11349	16678	16788	39	19
NC_010807.alt3	NC_025457.alt1	42.1053	57	11931	11987	20795	20746	24	33
NC_010807.alt3	NC_025457.alt1	48.2143	56	11828	11883	19647	19606	27	29
NC_010807.alt3	NC_025457.alt1	50.9091	55	3480	3534	10021	9968	28	27
NC_010807.alt3	NC_025457.alt1	47.2727	55	8970	9024	6072	6152	26	29
NC_010807.alt3	NC_025457.alt1	49.0909	55	16197	16251	26402	26443	27	28
NC_010807.alt3	NC_025457.alt1	4e+01	55	28487	28541	26185	26139	22	33
NC_010807.alt3	NC_025457.alt1	58.4906	53	18520	18572	19186	19263	31	22
NC_010807.alt3	NC_025457.alt1	52.9412	51	31739	31789	24429	24482	27	24
NC_010807.alt3	NC_025457.alt1	58.8235	51	38558	38608	11255	11308	30	21
NC_010807.alt3	NC_025457.alt1	72.9167	48	20896	20943	11844	11899	35	13
NC_010807.alt3	NC_025457.alt1	56.25	48	25283	25330	33568	33530	27	21
NC_010807.alt3	NC_025457.alt1	60.4167	48	28166	28213	3627	3571	29	19
NC_010807.alt3	NC_025457.alt1	56.25	48	39080	39127	25996	25948	27	21
NC_010807.alt3	NC_025457.alt1	63.0435	46	28297	28342	23039	23102	29	17
NC_010807.alt3	NC_025457.alt1	55.5556	45	10215	10259	33895	33932	25	20
NC_010807.alt3	NC_025457.alt1	68.8889	45	20186	20230	23184	23220	31	14
NC_010807.alt3	NC_025457.alt1	63.6364	44	1271	1314	4213	4267	28	16
NC_010807.alt3	NC_025457.alt1	65	40	15988	16027	24162	24097	26	14
NC_010807.alt3	NC_025457.alt1	72.5	40	23148	23187	38006	38057	29	11
NC_010807.alt3	NC_025457.alt1	72.5	40	38410	38449	23059	23001	29	11
NC_010807.alt3	NC_025457.alt1	55.2632	38	2120	2157	22002	22037	21	17
NC_010807.alt3	NC_025457.alt1	57.8947	38	25234	25271	15646	15676	22	16
NC_010807.alt3	NC_025457.alt1	69.4444	36	19583	19618	12595	12560	25	11
NC_010807.alt3	NC_025457.alt1	77.1429	35	8053	8087	30792	30831	27	8
NC_010807.alt1	NC_025457.alt2	53.4091	88	6902	6989	43810	43694	47	41
NC_010807.alt1	NC_025457.alt2	54.5455	66	32673	32738	59899	59978	36	30
NC_010807.alt1	NC_025457.alt2	45.4545	66	38482	38547	16719	16664	30	36
NC_010807.alt1	NC_025457.alt2	55.3846	65	33475	33539	40328	40444	36	29
NC_010807.alt1	NC_025457.alt2	58.4615	65	35210	35274	24543	24601	38	27
NC_010807.alt1	NC_025457.alt2	55.7377	61	10891	10951	7268	7367	34	27
NC_010807.alt1	NC_025457.alt2	61.0169	59	25350	25408	14283	14351	36	23
NC_010807.alt1	NC_025457.alt2	52.5424	59	38550	38608	5907	5860	31	28
NC_010807.alt1	NC_025457.alt2	63.7931	58	7729	7786	61743	61652	37	21
NC_010807.alt1	NC_025457.alt2	5e+01	58	13895	13952	14698	14781	29	29
NC_010807.alt1	NC_025457.alt2	58.6207	58	34037	34094	12213	12123	34	24
NC_010807.alt1	NC_025457.alt2	62.0690	58	37322	37379	5847	5794	36	22
NC_010807.alt1	NC_025457.alt2	42.1053	57	10973	11029	33636	33587	24	33
NC_010807.alt1	NC_025457.alt2	49.0909	55	26174	26228	49267	49312	27	28
NC_010807.alt1	NC_025457.alt2	46.2963	54	9296	9349	28754	28798	25	29
NC_010807.alt1	NC_025457.alt2	55.5556	54	19112	19165	8359	8410	30	24
NC_010807.alt1	NC_025457.alt2	59.6154	52	79	130	11474	11438	31	21
NC_010807.alt1	NC_025457.alt2	54.9020	51	15060	15110	38985	39046	28	23
NC_010807.alt1	NC_025457.alt2	54	50	9114	9163	6743	6678	27	23
NC_010807.alt1	NC_025457.alt2	63.2653	49	11157	11205	14729	14789	31	18
NC_010807.alt1	NC_025457.alt2	60.4167	48	17509	17556	41689	41759	29	19
NC_010807.alt1	NC_025457.alt2	52.0833	48	21517	21564	18185	18152	25	23
NC_010807.alt1	NC_025457.alt2	45.8333	48	27672	27719	25541	25501	22	26
NC_010807.alt1	NC_025457.alt2	61.7021	47	145	191	37016	37060	29	18
NC_010807.alt1	NC_025457.alt2	55.5556	45	4816	4860	35341	35277	25	20
NC_010807.alt1	NC_025457.alt2	6e+01	45	28427	28471	24526	24469	27	18
NC_010807.alt1	NC_025457.alt2	6e+01	45	36515	36559	53662	53624	27	18
NC_010807.alt1	NC_025457.alt2	56.8182	44	767	810	8708	8740	25	19
NC_010807.alt1	NC_025457.alt2	59.0909	44	19539	19582	54195	54248	26	18
NC_010807.alt1	NC_025457.alt2	52.2727	44	20577	20620	9500	9531	23	21
NC_010807.alt1	NC_025457.alt2	62.7907	43	23647	23689	43684	43742	27	16
NC_010807.alt1	NC_025457.alt2	69.0476	42	8844	8885	36330	36374	29	13
NC_010807.alt1	NC_025457.alt2	61.9048	42	14274	14315	46342	46267	26	16
NC_010807.alt1	NC_025457.alt2	57.1429	42	24048	24089	41076	41109	24	18
NC_010807.alt1	NC_025457.alt2	61.9048	42	29708	29749	14449	14477	26	16
NC_010807.alt1	NC_025457.alt2	63.4146	41	16577	16617	58789	58854	26	15
NC_010807.alt1	NC_025457.alt2	60.9756	41	18150	18190	2292	2355	25	16
NC_010807.alt1	NC_025457.alt2	7e+01	40	4158	4197	1782	1743	28	12
NC_010807.alt1	NC_025457.alt2	65	40	32398	32437	41514	41484	26	14
NC_010807.alt1	NC_025457.alt2	57.5	40	38094	38133	56840	56918	23	17
NC_010807.alt1	NC_025457.alt2	64.1026	39	4265	4303	48596	48522	25	14
NC_010807.alt1	NC_025457.alt2	55.2632	38	1256	1293	23870	23835	21	17
NC_010807.alt1	NC_025457.alt2	64.8649	37	12886	12922	23090	23164	24	13
NC_010807.alt1	NC_025457.alt2	72.2222	36	2848	2883	57805	57746	26	10
NC_010807.alt1	NC_025457.alt2	61.1111	36	31118	31153	40653	40600	22	14
NC_010807.alt1	NC_025457.alt2	74.2857	35	4319	4353	31469	31503	26	9
NC_010807.alt1	NC_025457.alt2	6e+01	35	7259	7293	36697	36636	21	14
NC_010807.alt1	NC_025457.alt2	71.4286	35	18726	18760	19790	19834	25	10
NC_010807.alt1	NC_025457.alt1	47	100	34591	34690	6290	6173	47	53
NC_010807.alt1	NC_025457.alt1	55.5556	72	32975	33046	35485	35403	40	32
NC_010807.alt1	NC_025457.alt1	54.4118	68	1069	1136	7457	7352	37	31
NC_010807.alt1	NC_025457.alt1	40.3226	62	17836	17897	6007	6055	25	37
NC_010807.alt1	NC_025457.alt1	44.0678	59	22616	22674	34705	34751	26	33
NC_010807.alt1	NC_025457.alt1	67.2414	58	10334	10391	16678	16788	39	19
NC_010807.alt1	NC_025457.alt1	42.1053	57	10973	11029	20795	20746	24	33
NC_010807.alt1	NC_025457.alt1	48.2143	56	10870	10925	19647	19600	27	29
NC_010807.alt1	NC_025457.alt1	47.2727	55	8128	8182	6072	6152	26	29
NC_010807.alt1	NC_025457.alt1	49.0909	55	15828	15882	26402	26443	27	28
NC_010807.alt1	NC_025457.alt1	4e+01	55	28510	28564	26185	26139	22	33
NC_010807.alt1	NC_025457.alt1	57.4074	54	19112	19165	29693	29744	31	23
NC_010807.alt1	NC_025457.alt1	58.4906	53	17967	18019	19186	19263	31	22
NC_010807.alt1	NC_025457.alt1	53.8462	52	81	132	34701	34745	28	24
NC_010807.alt1	NC_025457.alt1	52.9412	51	31487	31537	24429	24482	27	24
NC_010807.alt1	NC_025457.alt1	58.8235	51	37482	37532	11255	11308	30	21
NC_010807.alt1	NC_025457.alt1	72.9167	48	20575	20622	11844	11899	35	13
NC_010807.alt1	NC_025457.alt1	56.25	48	24660	24707	33568	33530	27	21
NC_010807.alt1	NC_025457.alt1	60.4167	48	28027	28074	3627	3571	29	19
NC_010807.alt1	NC_025457.alt1	56.25	48	38004	38051	25996	25948	27	21
NC_010807.alt1	NC_025457.alt1	63.0435	46	28158	28203	23039	23102	29	17
NC_010807.alt1	NC_025457.alt1	55.5556	45	9373	9417	33895	33932	25	20
NC_010807.alt1	NC_025457.alt1	68.8889	45	19865	19909	23184	23220	31	14
NC_010807.alt1	NC_025457.alt1	65	40	15457	15496	24162	24097	26	14
NC_010807.alt1	NC_025457.alt1	72.5	40	22718	22757	38006	38057	29	11
NC_010807.alt1	NC_025457.alt1	72.5	40	37334	37373	23059	23001	29	11
NC_010807.alt1	NC_025457.alt1	55.2632	38	1256	1293	22002	22037	21	17
NC_010807.alt1	NC_025457.alt1	57.8947	38	24611	24648	15646	15676	22	16
NC_010807.alt1	NC_025457.alt1	69.4444	36	18820	18855	12595	12560	25	11
NC_010807.alt1	NC_025457.alt1	77.1429	35	7349	7383	30792	30831	27	8
NC_010807.ref	NC_025457.alt2	53.4091	88	7528	7615	43810	43694	47	41
NC_010807.ref	NC_025457.alt2	48.2759	87	24779	24865	30313	30238	42	45
NC_010807.ref	NC_025457.alt2	54.5455	66	32673	32738	59899	59978	36	30
NC_010807.ref	NC_025457.alt2	45.4545	66	38482	38547	16719	16664	30	36
NC_010807.ref	NC_025457.alt2	55.3846	65	33475	33539	40328	40444	36	29
NC_010807.ref	NC_025457.alt2	58.4615	65	35210	35274	24543	24601	38	27
NC_010807.ref	NC_025457.alt2	55.7377	61	11633	11693	7268	7367	34	27
NC_010807.ref	NC_025457.alt2	59.3220	59	25350	25408	14283	14351	35	24
NC_010807.ref	NC_025457.alt2	52.5424	59	38550	38608	5907	5860	31	28
NC_010807.ref	NC_025457.alt2	63.7931	58	8355	8412	61743	61652	37	21
NC_010807.ref	NC_025457.alt2	5e+01	58	14457	14514	14698	14781	29	29
NC_010807.ref	NC_025457.alt2	56.8966	58	14598	14655	42126	42170	33	25
NC_010807.ref	NC_025457.alt2	58.6207	58	34037	34094	12213	12123	34	24
NC_010807.ref	NC_025457.alt2	62.0690	58	37322	37379	5847	5794	36	22
NC_010807.ref	NC_025457.alt2	42.1053	57	11715	11771	33636	33587	24	33
NC_010807.ref	NC_025457.alt2	49.0909	55	26174	26228	49267	49312	27	28
NC_010807.ref	NC_025457.alt2	46.2963	54	9922	9975	28754	28798	25	29
NC_010807.ref	NC_025457.alt2	55.5556	54	19228	19281	8359	8410	30	24
NC_010807.ref	NC_025457.alt2	54.9020	51	15338	15388	38985	39046	28	23
NC_010807.ref	NC_025457.alt2	54	50	9740	9789	6743	6678	27	23
NC_010807.ref	NC_025457.alt2	63.2653	49	11899	11947	14729	14789	31	18
NC_010807.ref	NC_025457.alt2	60.4167	48	17625	17672	41689	41759	29	19
NC_010807.ref	NC_025457.alt2	52.0833	48	21517	21564	18185	18152	25	23
NC_010807.ref	NC_025457.alt2	45.8333	48	27672	27719	25541	25501	22	26
NC_010807.ref	NC_025457.alt2	61.7021	47	429	475	37016	37060	29	18
NC_010807.ref	NC_025457.alt2	55.5556	45	5442	5486	35341	35277	25	20
NC_010807.ref	NC_025457.alt2	6e+01	45	28427	28471	24526	24469	27	18
NC_010807.ref	NC_025457.alt2	6e+01	45	36515	36559	53662	53624	27	18
NC_010807.ref	NC_025457.alt2	56.8182	44	1213	1256	8708	8740	25	19
NC_010807.ref	NC_025457.alt2	59.0909	44	19539	19582	54195	54248	26	18
NC_010807.ref	NC_025457.alt2	52.2727	44	20577	20620	9500	9531	23	21
NC_010807.ref	NC_025457.alt2	62.7907	43	23647	23689	43684	43742	27	16
NC_010807.ref	NC_025457.alt2	69.0476	42	9470	9511	36330	36374	29	13
NC_010807.ref	NC_025457.alt2	71.4286	42	16420	16461	13208	13142	30	12
NC_010807.ref	NC_025457.alt2	57.1429	42	24048	24089	41076	41109	24	18
NC_010807.ref	NC_025457.alt2	61.9048	42	29708	29749	14449	14477	26	16
NC_010807.ref	NC_025457.alt2	63.4146	41	16693	16733	58789	58854	26	15
NC_010807.ref	NC_025457.alt2	60.9756	41	18266	18306	2292	2355	25	16
NC_010807.ref	NC_025457.alt2	7e+01	40	4784	4823	1782	1743	28	12
NC_010807.ref	NC_025457.alt2	57.5	40	38094	38133	56840	56918	23	17
NC_010807.ref	NC_025457.alt2	64.1026	39	4891	4929	48596	48522	25	14
NC_010807.ref	NC_025457.alt2	55.2632	38	1702	1739	23870	23835	21	17
NC_010807.ref	NC_025457.alt2	64.8649	37	13448	13484	23090	23164	24	13
NC_010807.ref	NC_025457.alt2	59.4595	37	32951	32987	53968	53996	22	15
NC_010807.ref	NC_025457.alt2	72.2222	36	3474	3509	57805	57746	26	10
NC_010807.ref	NC_025457.alt2	61.1111	36	31118	31153	40653	40600	22	14
NC_010807.ref	NC_025457.alt2	74.2857	35	4945	4979	31469	31503	26	9
NC_010807.ref	NC_025457.alt2	71.4286	35	18842	18876	19790	19834	25	10
NC_010807.ref	NC_025457.alt1	55.5556	72	32975	33046	35485	35403	40	32
NC_010807.ref	NC_025457.alt1	49.2754	69	22125	22193	27108	27197	34	35
NC_010807.ref	NC_025457.alt1	54.4118	68	1515	1582	7457	7352	37	31
NC_010807.ref	NC_025457.alt1	44.0678	59	22616	22674	34705	34751	26	33
NC_010807.ref	NC_025457.alt1	67.2414	58	11076	11133	16678	16788	39	19
NC_010807.ref	NC_025457.alt1	42.1053	57	11715	11771	20795	20746	24	33
NC_010807.ref	NC_025457.alt1	48.2143	56	11612	11667	19647	19600	27	29
NC_010807.ref	NC_025457.alt1	47.2727	55	8754	8808	6072	6152	26	29
NC_010807.ref	NC_025457.alt1	49.0909	55	15944	15998	26402	26443	27	28
NC_010807.ref	NC_025457.alt1	4e+01	55	28510	28564	26185	26139	22	33
NC_010807.ref	NC_025457.alt1	57.4074	54	19228	19281	29693	29744	31	23
NC_010807.ref	NC_025457.alt1	58.4906	53	18083	18135	19186	19263	31	22
NC_010807.ref	NC_025457.alt1	52.9412	51	31487	31537	24429	24482	27	24
NC_010807.ref	NC_025457.alt1	58.8235	51	37482	37532	11255	11308	30	21
NC_010807.ref	NC_025457.alt1	72.9167	48	20575	20622	11844	11899	35	13
NC_010807.ref	NC_025457.alt1	56.25	48	24660	24707	33568	33530	27	21
NC_010807.ref	NC_025457.alt1	60.4167	48	28027	28074	3627	3571	29	19
NC_010807.ref	NC_025457.alt1	56.25	48	38004	38051	25996	25948	27	21
NC_010807.ref	NC_025457.alt1	63.0435	46	28158	28203	23039	23102	29	17
NC_010807.ref	NC_025457.alt1	55.5556	45	9999	10043	33895	33932	25	20
NC_010807.ref	NC_025457.alt1	68.8889	45	19865	19909	23184	23220	31	14
NC_010807.ref	NC_025457.alt1	65	40	15735	15774	24162	24097	26	14
NC_010807.ref	NC_025457.alt1	72.5	40	22718	22757	38006	38057	29	11
NC_010807.ref	NC_025457.alt1	72.5	40	37334	37373	23059	23001	29	11
NC_010807.ref	NC_025457.alt1	55.2632	38	1702	1739	22002	22037	21	17
NC_010807.ref	NC_025457.alt1	57.8947	38	24611	24648	15646	15676	22	16
NC_010807.ref	NC_025457.alt1	69.4444	36	18936	18971	12595	12560	25	11
NC_010807.ref	NC_025457.alt1	77.1429	35	7975	8009	30792	30831	27	8
